umhlaba	u m hlaba
emlonyeni	e m lony eni
wayesezibonela	w a ye se zi bon el a
ayelokhu	a ye lokhu
usehlulekile	u se hlulek ile
ihlo	i hlo
abawa	a ba w a
akafuni	a ka fun i
abahle	a ba hle
yomlamu	y o m lamu
ngomlomo	ng o m lomo
nodokotela	n o dokotela
engisithandayo	e ngi si thand a yo
imidati	i mi dati
osengathi	o sengathi
nokuzonda	n o ku zond a
okungcono	o ku ngcono
asisahlezi	a si sa hlez i
esenziwa	e s enz iw a
ayesezilahle	a ye se zi lahl e
lubhekene	lu bhek en e
ufundela	u fund el a
esiwuqhotho	e si w u qhotho
nothisha	n o thisha
kovalo	k o valo
isango	i sango
amaphoyisa	a ma phoyisa
ngesinye	ng e si nye
empunzini	e m punz ini
ngibanjiwe	ngi banj iw e
ephela	e phel a
uyakukhumbula	u ya ku khumbul a
angazi	a ng azi
ukungayi	u ku nga y i
angaze	a ngaz e, a nga ze
sathula	s a thul a
azombulala	a zo m bulal a
ayeneliswa	a y enel is w a
licisha	li cish a
lomuntu	l o mu ntu
ukubeka	u ku bek a
kumike	ku m i ke
ezasephusheni	e za se phush eni
engasatholi	e nga sa thol i
kwenqatshiwe	kw enqatsh iw e
uthokozile	u thokoz ile
ethengela	e theng el a
ngiyagomela	ngi ya gom el a
emgqeni	e m gq eni
ugumede	u gumede
wadonsa	w a dons a
ukuyofakelwa	u ku yo fak el w a
nawe	na we
bakhona	ba kho na
babephilisa	ba be phil is a
ngaphambi	nga phambi
aphuma	a phum a
aphume	a phum e
kungababi	ku nga bab i
yokwehla	y o kw ehl a
ngelinye	ng e li nye
nanokuthi	na n o kuthi
kuyahlanganwa	ku ya hlangan w a
ngihambe	ngi hamb e
ngihamba	ngi hamb a
ngodishani	ng o dishani
bakhathazwe	ba khathaz w e
lasezingobhe	la se zin gobhe
esibozini	e si boz ini
emude	e mu de
matanami	ma tanami
ukoba	u ko b a
nokuphila	n o ku phil a
uyosithela	u yo si thel a, u yo sithel a
uphelile	u phel ile
ithi	i thi
uthandazela	u thandaz el a
kwangithokozisa	kw a ngi thokoz is a
uhlulwa	u hlul w a
ithe	i th e
nxashana	nxashana
inkosi	i n kosi
ngijike	ngi jik e
phakathi	phakathi
ufisa	u fis a
zizibeke	zi zi bek e
sisekhona	si se kho na
bakhombise	ba khomb is e
kubonelela	ku bonel el a
lingahlaba	li nga hlab a
ungabulali	u nga bulal i
kangisakwazi	ka ngi sa kw azi
ngowomunye	ng o w o mu nye
kwafumaniseka	kw a fuman is ek a
kungahle	ku nga hle
ukuzisola	u ku zisol a
nothogarma	n o thogarma
abasahleki	a ba sa hlek i
ekufake	e ku fak e
ungabhayizi	u nga bhayiz i
izinyathi	i zi nyathi
ngidlala	ngi dlal a
ezimbusisayo	e zi m busis a yo
aqhwakele	a qhwak el e
ngezacile	ng e zac ile
sebengayibhala	se be nga yi bhal a
linjalo	li njalo
sekufiwe	se ku f iw e
ukuziqhenya	u ku zi qheny a
ongakaze	o nga ka ze
kochitheka	k o chith ek a
uzophupha	u zo phuph a
esitheshini	e si thesh ini
waphikelela	w a phikel el a
okuzokonakala	o ku zo k on akal a
patsha	patsha
yalibamba	y a li bamb a
wabanyonkoloza	w a ba nyonkoloz a
isikhwehlela	i si khwehlel a
zikapopo	zika popo
necebo	n e ceb o
uyodideka	u yo did ek a
amfice	a m fic e
ngowokuba	ng o w o kuba
bheka	bhek a
nawoqukula	na w o qukul a
sinjani	si njani
nantathu	na n tathu
nomkakhe	n o m ka khe
ngenzenjani	ng enz e njani
nomkakho	n o m ka kho
ngxi	ngxi
luzodingidwa	lu zo dingid w a
elishisayo	e li shis a yo
bazithintile	ba zi thint ile
uyifunde	u yi fund e
alishaye	a li shay e
kungcola	ku ngcol a
esithumelele	e si thumel el e
azisalanga	a zi sal anga
seliphumile	se li phum ile
izingqomondo	i zin gqomondo
ingafundwa	i nga fund w a
nobuso	n o bu so
emikhulu	e mi khulu
sekungamazinyo	se ku ng a ma zinyo
wayithola	w a yi thol a
iphambukile	i phambuk ile
nempela	n empela
iwezifundo	i w e zi fund o
aphengule	a phengul e
shwele	shwele
angakuthatha	a nga ku thath a
bubangwa	bu bang w a
ngiphelekezele	ngi phelekez el e, ngi phelekezel e
bamthunge	ba m thung e
asitshele	a si tshel e
bakhe	ba khe
iwaphonse	i wa phons e
umfundi	u m fund i
bakho	ba kho
ngasefilidi	nga se filidi
ngamarandi	ng a ma randi
ikileku	i kileku
lwalumnandi	lw a lu mnandi
izifundo	i zi fund o
akukhethi	a ku kheth i
emsamo	e m samo
yalithi	y a li thi
yaqapha	y a qaph a
komnumzane	k o m numzane
uyesabeka	u y esab ek a
sasize	s a siz e
zicabange	zi cabang e
akwenzele	a kw enz el e
uzocasha	u zo cash a
mnumzane	m numz ane, m numzane
asazike	a s azi ke
bengazibekile	be nga zi bek ile
bakhathele	ba khathel e
ayeziqoqele	a ye zi qoq el e
lumbelesele	lu m beles el e, lu m belesel e
njalo	njalo
lizama	li zam a
isibuya	i s i buy a
olungiselela	o lung is elel a
wagulukudela	w a gulukudel a
nesifo	n e si f o
nalenkinga	na le n kinga
yakwethu	y akwethu
ukusebenzisa	u ku sebenz is a
lubenjalo	lu b e njalo
sekumbambe	se ku m bamb e
wavele	w a vele
iqhamuka	i qhamuk a
lanamhlanje	la namhlanje
aseyicabangile	a se yi cabang ile
sasemanzimtoti	sa se ma nzi mtoti
esabaleka	e sa balek a
zemithi	z e mi thi
ezansi	e zansi
isihloma	i si hlom a
uthini	u thi ni
uyathengisa	u ya theng is a
washonelwa	w a shon el w a
masehlukane	ma s ehluk an e
wethoka	w ethok a
ngami	nga mi
babone	ba bon e
linikezwe	li nikez w e
babona	b a bon a, ba bon a
wayengabala	w a ye nga bal a
umbhali	u m bhal i
ngabuye	ng a buy e
ngabuya	ng a buy a
emnyameni	e m nyam eni
kunjalo	ku njalo
kulonesi	ku lo nesi
uyeza	u y ez a
wayesejike	w a ye se jik e
wase	w a se
isigqoko	i si gqok o
ababengekho	a ba be nge kho
engikubizele	e ngi ku biz el e
etsheliwe	e tshel iw e
engiphethe	e ngi pheth e
basanda	ba sand a
okweqa	o kw eq a
abancane	a ba ncane
ngenkathi	ng e n kathi
waphindela	w a phindel a
ngingaphumeleli	ngi nga phumelel i
amantombazane	a ma ntombaz ane
kuswelekile	ku swel ek ile
ukuyizwa	u ku yi zw a
basho	ba sho
asemqoka	a se m qok a
basha	ba sh a
useyaqeda	u se ya qed a
izibondlo	i zi bondlo
idla	i dl a
wathumela	w a thumel a
hayi	hayi
babebathole	ba be ba thol e
esebuza	e se buz a
izimali	i zi mali
esekhulelile	e se khul el ile
sigodo	si godo
uqhubeke	u qhub ek e
uqhubeka	u qhub ek a, u qhubek a
abaningi	a ba ningi
khona	kho na
ngokwedlulele	ng o kw edlul el e
ngamnika	ng a m nik a
ewudweba	e wu dweb a
wangithena	w a ngi then a
umkami	u m kami
namhlanje	na m hla nje
besamangele	be sa mangel e
ehawukele	e hawukel e
ekulelibutho	e ku le li buth o
sithunyiwe	si thuny iw e
ukuthuthukisa	u ku thuthuk is a
wawungathi	w a wu nga thi
abahwathuzisa	a ba hwathuz is a
uzozichaza	u zo zi chaz a
ababejayiva	a b a be jayiv a
nesigqoko	n e si gqok o
wavuka	w a vuk a
kwasa	kw a s a
kudokotela	ku dokotela
ngamangala	ng a mangal a
kwase	kw a se
ibhekene	i bhek en e
ngesikade	ng e si kade
eziyikitazayo	e zi yi kitaz a yo
uzwile	u zw ile
akacabangi	a ka cabang i
okwami	o kwa mi
ngiyabamba	ngi ya bamb a
ikhala	i khal a, i khala
owawudlalwa	o w a wu dlal w a
engenalo	e nge na lo
usikhwama	u sikhwama
ngasemobeni	nga se mob eni
abasaphathekile	a ba sa phath ek ile
bajeziselwani	ba jez is el w a ni
bekade	be kade
siyakukhuphukelaphi	si ya ku khuphuk el a phi
exoshana	e xosh an a
akuthi	a ku th i
ngingumuntu	ngi ng u mu ntu
eyiyeka	e yi yek a
seyaziganelwa	se y a zi gan el w a
ukuhlala	u ku hlal a
nomzimba	n o m zimba
umlambo	u m lambo
kwakumalini	kw a ku mali ni
sekungalalwa	se ku nga lal w a
ingubo	i n gubo
asihambe	a si hamb e
agane	a gan e
liyenzeka	li y enz ek a
kokusifaka	k o ku si fak a
ngezansana	ng e zans ana
okwesikhukhukazi	o kw e si khukhu kazi
ngokwezandla	ng o kw e z andla
nangwe	na n gwe
ngokungibhinqa	ng o ku ngi bhinq a
ebusweni	e bus w eni
awuzithathi	a wu zi thath i
azizwe	a zi zw e
wayongena	w a yo ngen a
wayobheka	w a yo bhek a
ongaphandle	o nga phandle
wabaleka	w a balek a
uyabaleka	u ya ba lek a, u ya balek a
usezwa	u sez w a
engeseduze	e nge se duze
elinye	e li nye
zonya	zony a
asebenza	a sebenz a
eyishumi	e y i shumi
egculisiwe	e gcul is iw e
yayimbude	y a y i m bude
idadamu	i dadamu
bawathenge	ba wa theng e
owangithanda	o w a ngi thand a
sekuyidwala	se ku y i dwala
ngivele	ngi vel e
kucace	ku cac e
ahamba	a hamb a
ahambe	a hamb e
bese	be se
uzihlalele	u zi hlal ele
amanye	a ma nye
benjalo	be njalo
zodwa	zo dwa
imvimbezele	i m vimbezel e
nomalume	n o malume
izothululwa	i zo thulul w a
nokuthatha	n o ku thath a
zaso	za so
uchabo	u chabo
nawo	na wo
ngezifuba	ng e zi fuba
zezinsizwa	z e zin sizwa
emangcwabeni	e ma ngcwab eni
ongaphakathi	o nga phakathi
bayabubula	ba ya bubul a
umoya	u moya
yayomnquma	y a yo m nqum a
akwanele	a kw anel e
siyamluma	si ya m lum a
ebeka	e bek a
akukhona	a ku kho na
uzondi	u zondi
imicabango	i mi cabang o
ngenanyiswe	ng enany is w e
ngingumthakathi	ngi ng u m thakath i
kangilimile	ka ngi lim ile
ngci	ngci
kungakangeni	ku nga ka ngen i
ngisabambeke	ngi sa bamb ek e
waqeda	w a qed a
ijubane	i jubane
kwakungugamaliyeli	kw a ku ng u gamaliyeli
izinyanga	i zi nyanga
angilandiwe	a ngi land iw e
engivelelayo	e ngi vel el a yo
entshebeni	e n tsheb eni
esefikelwa	e se fik el w a
nayo	na yo
owayebekwa	o w a ye bek w a
naye	na ye
kwazulu	kwa zulu
kankosi	ka n kosi
osekuthanda	o se ku thand a
kwakusebenza	kw a ku sebenz a
bengisemanzimtoti	be ngi se ma nzi mtoti
ngesilima	ng e si lima
isabhaleka	i sa bhal ek a
makenze	ma k enz e
ehleli	e hlel i
idlangala	i dlangal a
ebandla	e bandl a
iphupho	i phuph o
asikwenzanga	a si kw enz anga
bangibiza	ba ngi biz a
behla	b ehl a
edwaleni	e dwal eni
saqhubeka	s a qhub ek a
amapotimende	a ma potimende
alunga	a lung a
ikakhulu	i ka khulu
kumenele	ku m enel e
labonamakhosikazi	la b o n a ma khosi kazi
ikhulu	i khulu
ngibone	ngi bon e
ngibona	ngi bon a
sebemenza	se be m enz a
wakuzwa	w a ku zw a
kamandlakhe	ka ma ndla khe
nokwami	n o kwa mi
amathambo	a ma thambo
elikhinyabezwe	e li khinyabez w e
useyixoxe	u se yi xox e
esesebenza	e se sebenz a
ufikile	u fik ile
esiklebheni	e si klebh eni
buhlungu	buhlungu
eshiywe	e shiy w e
yafika	y a fik a
yahlupha	y a hluph a
ozobaphathisa	o zo ba phath is a
kamina	ka mi na
asemhenqa	a se m henq a
kuhomuzela	ku homuz el a
zixutshwe	zi xutsh w e
esondela	e sondel a
emakeloti	e ma keloti
abalamu	a ba lamu
kokuchaza	k o ku chaz a
kuse	ku s e
sabuya	s a buy a
abakubo	a ba ku bo
sinazo	si na zo
esaphendula	e sa phendul a
ubebathanda	u be ba thand a
okuphe	o ku ph e
ungalimaza	u nga limaz a
yokuhlushwa	y o ku hlush w a
ukududula	u ku dudul a
njengoba	nje ngoba
ngikubiza	ngi ku biz a
ebhebhetheke	e bhebheth ek e
balaba	ba la ba
siyakubopha	si ya ku boph a
useyayizwa	u se ya yi zw a
abomvu	a bomvu
akuyikho	a ku yi kho
iminingi	i mi ningi
ejalidini	e jalid ini
sekukhona	se ku kho na
indlovu	i n dlovu
yamukelwe	y amuk el w e
sekugcwele	se ku gcwel e
komngane	k o m ngane
kufike	ku fik e
kufika	ku fik a
kungcono	ku ngcono
malokazana	ma lokazana
ngangingasenandaba	ng a ngi nga se na n daba
ukugubhazela	u ku gubhazel a
uma	uma
ngilibophe	ngi li boph e
siphuthuma	si phuthum a
ngisebenza	ngi sebenz a
kokuhlabeka	k o ku hlab ek a
engagulanga	e nga gul anga
kwakugcwaliseka	kw a ku gcwal is ek a
ngamagama	ng a ma gama
badela	ba del a
ungaya	u nga y a
eseyimnika	e se yi m nik a
mfana	m fana
ukamahlaba	u ka ma hlaba
sasibhalwe	s a si bhal w e
zokumvikela	z o ku m vik el a
o	o
befuna	be fun a
wedlula	w edlul a
elalingene	e l a li ngen e
umane	u mane
mbo	mbo, m bo
babengobani	ba be ng o bani
kususwe	ku sus w e
kususwa	ku sus w a
nanka	nan ka
unyawo	u nyawo
ahlale	a hlal e
ahlala	a hlal a
leshumi	l e shumi
singakenzi	si nga k enz i
wayengahlezi	w a ye nga hlez i
wedelela	w edelel a
imshiye	i m shiy e
kwechibi	kw e chibi
ngakugcina	ng a ku gcin a
belikade	be li kade
zondi	zondi
kazidakiwe	ka zi dak iw e
okirani	o kirani
sengizwa	se ngi zw a
banibani	banibani
abazofuna	a ba zo fun a
kusashisa	ku sa shis a
nokugqiha	n o ku gqih a
ukuhambisana	u ku hambis an a
ezwile	e zw ile
somngane	s o m ngane
azi	azi
ukusuka	u ku suk a
ngizomsiza	ngi zo m siz a
kumkhaya	ku m khaya
layo	la yo
umgexo	u m gex o
baze	ba ze
endodaneni	e n dod an eni
sesiyokhumbula	se si yo khumbul a
isebenzisa	i sebenz is a
emeveni	e me v eni
ezincwadini	e zi ncwad ini
angahamba	a nga hamb a
ngangivuka	ng a ngi vuk a
iphuma	i phum a
nawuvadlwana	na w u vadlw ana
iphume	i phum e
ayesenawo	a ye se na wo
esukuma	e sukum a
ibihlekiswa	i b i hlek is w a
nalamaphoyisa	na la ma phoyisa
ngiyibhalele	ngi yi bhal el e
kengisho	ke ngi sho
kungangcono	ku nga ngcono
okuhle	o ku hle
ukhala	u khal a
ethanda	e thand a
ibhale	i bhal e
akazukuba	a ka zu ku b a
ihambe	i hamb e
akhushulelwe	a khushul el w e
kwabona	kw a bon a
enye	e nye
sizithanda	si zi thand a
izimfunda	i zim funda
uphethe	u pheth e
ayokuthola	a yo ku thol a
iziteshana	i zi tesh ana
ukufinyeza	u ku finyez a
yidwala	y i dwala
esethandile	e se thand ile
nxa	nxa
ozibhekela	o zi bhek el a
umhlabathi	u m hlabathi
ayifunde	a yi fund e
engafuni	e nga fun i
kuyintshwaquntshwaqu	ku y i n tshwaqu n tshwaqu
akucabange	a ku cabang e
kwayikho	kw a yi kho
waphinda	w a phind a
ngaziphendula	ng a zi phendul a
ezogwinya	e zo gwiny a
kwakuyizincwadi	kw a ku y i zin cwadi
zokungahloniphi	z o ku nga hloniph i
ebhayibhelini	e bhayibhel ini
okwase	o kw a se
nabanye	n a ba nye
kwedlula	kw edlul a
wofaka	w o fak a
indiva	i n diva
kubonakala	ku bon akal a
esicathama	e si catham a
kumduduze	ku m duduz e, ku mduduz e
wavuma	w a vum a
kalingcoli	ka li ngcol i
wazibonela	w a zi bon el a
amadlangala	a ma dlangala
esalokhu	e sa lokhu
angisakushiyi	a ngi sa ku shiy i
uyokwenza	u yo kw enz a
busabuya	bu sa buy a
usalindele	u sa lindel e
laphaya	lapha ya
uhola	u hol a
nothanda	n o thand a
nothando	n o thand o
uselele	u se lel e
unomhlanjana	u n o m hlanj ana
ongafuni	o nga fun i
kwakuqhwakele	kw a ku qhwak el e
onethiwe	o neth iw e
ukungihlupha	u ku ngi hluph a
wazizwa	w a zi zw a
lakuxosha	l a ku xosh a
lempethu	le m pethu
nezinhlanhla	n e zin hlanhla
nokuthenga	n o ku theng a
lifuna	li fun a
wayefana	w a ye fan a
bekungahambi	be ku nga hamb i
hhiya	hhiya
lapho	laph o
ufa	u f a
lapha	lapha
kusize	ku siz e
langa	langa, l ang a
ngiyakwazi	ngi ya kw azi
iwempela	i w e mpela
sengiyezwa	se ngi y ezw a
ngokuhamba	ng o ku hamb a
ukukusho	u ku ku sho
esesondela	e se sondel a
kubengathi	ku be nga thi
elayeze	e layez e
ayisindwa	a yi sind w a
bayigqoma	ba yi gqom a
nginuka	ngi nuk a
ukukhethwa	u ku kheth w a
nokusho	n o ku sho
uchakijana	u chakijana
ukwethembana	u kw ethemb an a
usezukeke	u se zukek e
ngamenzela	ng a m enz el a
bekuthiwe	be ku th iw e
nenkulumo	n e n kulum o
ethatha	e thath a
mfowethu	m fo w ethu
usangithinta	u sa ngi thint a
yibumfingomfingo	y i bumfingomfingo
kokungqongqotha	k o ku ngqongqoth a
unemali	u n e mali
iyivukele	i yi vuk el e
efrayimi	efrayimi
uthembi	u themb i
nezigameko	n e zi gamek o
angiphekile	a ngi phek ile
hlala	hlal a
usuze	u s u z e, u suz e
usuza	u suz a
ukumbona	u ku m bon a
ayomthengela	a yo m theng el a
wenqindi	w e n qindi
entubeni	e n tub eni
kachakide	ka chakide
phambi	phambi
abuveze	a bu vez e
kungabi	ku nga b i
sengathi	sengathi
limshiya	li m shiy a
kwalababelungu	kwa la ba be lungu
okohlanya	o k o hlanya
walishiya	w a li shiy a
babengenakulokotha	ba be nge na ku lokoth a
wayegebisele	w a ye geb is el e
kwebandla	kw e bandla
iyoqoma	i yo qom a
beqonde	be qond e
ephelele	e phel el e
usola	u sol a
ikhandlela	ikhandlela
kwetshe	kw e tshe
useze	u se ze
uqedile	u qed ile
abagulayo	a ba gul a yo
wayengezukuyigquma	w a ye nge zu ku yi gqum a
kungene	ku ngen e
ikumfowabo	i ku m fo wa bo
ayiwuhlanganisile	a yi wu hlangan is ile
ipeni	i peni
esibucayi	e si bucayi
yamazulu	y a ma zulu
ngikwenze	ngi kw enz e
engakwenza	e nga kw enz a
ezase	e z a se
buqamamana	bu qamam ana
osezoba	o se zo b a
asondele	a sondel e
nethuba	n e thuba
abakuboni	a ba ku bon i
isikhathi	i si khathi
aphindele	a phind el e
lezizingane	le zi zin gane
ngifanele	ngi fanel e
egoli	e goli
ufanele	u fanel e
mpelampela	mpela mpela
zabantu	z a ba ntu
alithole	a li thol e
ongajaha	o nga jah a
njulo	n jul o
kanye	ka nye
sebeyisebenza	se be yi sebenz a
omncane	o m ncane
esebheke	e se bhek e
iziboniso	i zi bon is o
bangathengi	ba nga theng i
usuhambe	u s u hamb e
ukhohlwe	u khohl w e
limbe	li mb e
sakhelene	s akh el en e
bekwenzenjani	be kw enz e njani
kuthinteke	ku thint ek e
kunamuhla	ku na mu hla
zithi	zi thi
engeshekelelayo	e nge shekel el a yo
yokuhlela	y o ku hlel a
kwadingeka	kw a ding ek a
ngokweqisa	ng o kw eq is a
namakapisi	n a ma kapisi
lingifudumeza	li ngi fudumez a
likankosikazi	lika nkosi kazi
bemisa	be m is a
ngabaxhasi	ng a ba xhas i
ubekuphethe	u be ku pheth e
kamili	kamili
akasakhulumisi	a ka sa khulum is i
kuneyakho	kun e ya kho
kuxoxwa	ku xox w a
kuxoxwe	ku xox w e
imphendule	i m phendul e
obeyibhala	o be yi bhal a
kuzondi	ku zondi
nginehlule	ngi n ehlul e
inhlansi	i n hlansi
ngaphakathi	nga phakathi
namarandi	n a ma randi
buzala	bu zal a
ngisukele	ngi suk el e
alwa	a lw a
abalisa	a ba lisa
ngingustephan	ngi ng u stephan
sekufike	se ku fik e
okwentwala	o kw e n twal a
ngikucabanga	ngi ku cabang a
ibuyela	i buy el a
wawubulala	w a wu bulal a
yayiqonde	y a yi qond e
etshwaleni	e tshwal eni
kwesikhathi	kw e si khathi
amanhlakomuzi	a ma n hlak o mu zi
okubhala	o ku bhal a
ungishisa	u ngi sh is a
esewubambile	e se wu bamb ile
wayiphupha	w a yi phuph a
sakhona	sa kho na
eyazi	e y azi
ewabheka	e wa bhek a
itholana	i thol an a
okuvamise	o ku vam is e
owawusuthande	o w a wu s u thand e
uzanele	u zanele
soze	s o ze
wathi	w a thi
uke	u ke
wamgxavula	w a m gxavul a
ukwanda	u kw and a
kacelemba	ka celemba
kundumezulu	ku n dum e zulu
ngidede	ngi ded e
womsiza	w o m siza
kwamxaka	kw a m xak a
ephuma	e phum a
ehleka	e hlek a
emithi	e mi thi
kajakobe	ka jakobe
emitha	e mith a
ubabona	u ba bon a
emizini	e mi z ini
liyavuleka	li ya vul ek a
njengomntanami	njeng o m ntana mi
lalimanzi	l a li manzi
ngingafela	ngi nga f el a
leyonto	le y o n to
isisasambana	i si sasambana
udanisa	u dan is a
ngimkhonze	ngi m khonz e
kuphindelwa	ku phind el w a
wawashiya	w a wa shiy a
umfelokazi	u m f el o kazi
kusheshe	ku shesh e
nalapho	na laph o
yasehholo	ya se hholo
izinto	i zin to
ezathintwa	e z a thint w a
nalapha	na lapha
kuleso	ku le s o
iambulense	i ambulense
luhuntshu	lu huntshu
lwaba	lw a b a
akukhulunywa	a ku khuluny w a
ngiyobonga	ngi yo bong a
ngalendlela	nga le n dlela
besemvakwakhe	be s emva kwa khe
ulungisa	u lung is a
elele	e lel e
ukuyisebenzisa	u ku yi sebenz is a
ephendula	e phendul a
uyakhwishiza	u ya khwishiz a
sengiyajabula	se ngi ya jabul a
lamehlo	la me hlo
sala	s al a, sal a
laphayana	lapha ya na
lawa	la wa
nabantu	n a ba ntu
eqala	e qal a
wawagqumuza	w a wa gqumuz a
sengijikile	se ngi jik ile
laphoke	laph o ke
ekuphi	e ku phi
kunoma	ku noma
umbhede	u m bhede
abayosiza	a ba yo siz a
bafike	ba fik e
bafika	ba fik a
inkungu	i n kungu
makamemeze	ma ka memez e
izikhafu	i zi khafu
ombonile	o m bon ile
bangobani	ba ng o bani
ukusenga	u ku seng a
usibhamu	u si bhamu
ngikukhululela	ngi ku khululel a
yayiminingi	yayiminingi
ngisamfica	ngi sa m fic a
wayo	wa yo
embotsheni	e m botsh eni
beqhubekela	be qhub ek el a
isizengu	i si zengu
wayeyolala	w a ye yo lal a
kwangathi	kw a nga thi
ukukufanisa	u ku ku fan is a
amatiye	a ma tiye
zazingekho	z a zi nge kho
singakuphawula	si nga ku phawul a
waya	w a y a
phambili	phambili
lakhohlwa	l a khohl w a
sekuba	se ku b a
ngiwabuza	ngi wa buz a
wawugqashula	w a wu gqashul a
nomummy	n o mummy
sekukubi	se ku ku bi
wadumela	w a dumel a
zohlelo	z o hlel o
womunye	w o mu nye
uyisiwula	u y i si wula
ebishiwo	e b i sh iw o
eyiceke	e yi cek e
ngiyinkunzi	ngi y i n kunzi
uthwale	u thwal e
ubusuku	u bu suku
umkhize	u m khize
ngezinyembezi	ng e zi nyembezi
olwalubaneka	o lw a lu banek a
isifuna	i s i fun a
phapha	phaph a, phapha
athole	a thol e
kakudingi	ka ku ding i
ngangidonsela	ng a ngi dons el a
bengikhuzela	be ngi khuz el a
abangaboni	a ba nga bon i
unozwengaye	u n o zwengaye
umgqibelo	u m gqibel o
kwakulukhuni	kw a ku lukhuni
ubuzowuyalelwa	u b u zo wu yal el w a
ocela	o cel a
yamkhohlwa	y a m khohl w a
okungenani	o ku nge na ni
kwawa	k wa w a
kudambe	ku damb e
ngunyawo	ng u nyawo
singazi	si ng az i
bamphethe	ba m pheth e
epentrich	e pentrich
avuleka	a vul ek a
s	s
ezashaya	e z a shay a
bazichaze	ba zi chaz e
kwabantwana	kw a ba ntwana
engekho	e ng ekho
abulala	a bulal a
imbulunga	i m bulunga
abulale	a bulal e
ngithoka	ngi thok a
esezisebenza	e se zi sebenz a
mayiwazile	ma yi wa zil e
abebusa	a be bus a
anti	anti
babevamise	b a be vam is e
zazibethela	z a zi beth el a
akuvami	a ku vam i
ezimbi	e zim bi
ngikuhhumuzele	ngi ku hhumuz el e
ungicibele	u ngi cib el e
ephoxayo	e phox a yo
siyobe	si yo be
akungiphathi	a ku ngi phath i
udliwa	u dl iw a
bayaphefumula	ba ya phefumul a
wesilisa	w e silisa
somnqayi	s o m nqay i
ibiyini	i b i yi ni
koziphosa	k o zi phos a
yayikhelwe	y a yi khel w e, y a yi khelw e
kunkosi	ku n kosi
kusofa	ku sofa
yangena	y a ngen a
aliboni	a li bon i
sengenqena	se ng enqen a
ngikweluleka	ngi kw elulek a
uyadlala	u ya dlal a
zibahlonipha	zi ba hloniph a
likajamu	lika jamu
liyaphakama	li ya phakam a
okusalayo	o ku sal a yo
ebeziyigugu	e be zi y i gugu
esehlengezela	e se hlengez el a
buyasa	bu ya s a
ayinazindlebe	a yi na zin dlebe
kwashayansumoni	kw a shay a n sumo ni
bakwejwayele	ba kw ejwayel e
sebenginukile	se be ngi nuk ile
edobana	e dob an a
kuzolunga	ku zo lung a
banake	ba nak e
ubewanikelani	u be wa nik el a ni
nzima	nzima
engingayenza	e ngi nga y enz a
bamotha	ba m oth a
waphuma	w a phum a
wamamatheka	w a mamathek a
yamnika	y a m nik a
ngizobuka	ngi zo buk a
azidilizelwe	a zi diliz el w e
engangikwenza	e ng a ngi kw enz a
lesitimela	le si timela
unginike	u ngi nik e
engasiza	e nga siz a
wayohlala	w a yo hlal a
usheshe	u shesh e
lesibili	l e si bili
isheshise	i shesh is e
eseyilobile	e se yi lob ile
neyayishiwo	n e y a yi sh iw o
lingcono	li ngcono
emalokishini	e ma lokish ini
sesiyaqumbelana	se si ya qumb el an a
angahlela	a nga hlel a
obambisanayo	o bamb is an a yo
benze	b enz e
kwamamangalahlwa	kwa mamangalahlwa
kuwukuhlakanipha	ku w u ku hlakaniph a
bangacabangi	ba nga cabang i
amcele	a m cel e
esika	e sik a
sengiyamesaba	se ngi ya m esab a
umdelwa	u m del w a
ithikithi	i thikithi
wahixileka	w a hixil ek a
ukuzenzela	u ku z enz el a
ukuyengwa	u ku yeng w a
usegugile	u se gug ile
isisu	i si su
ubuhle	u bu hle
musani	mus a ni
ngiyisilima	ngi y i si lima
ngomkhonzo	ng o m khonz o
bayizwe	ba yi zw e
ongaluthola	o nga lu thol a
liyogcina	li yo gcin a
asasele	a sa sel e
unjengoyihlo	u njeng o yihlo
amanani	a ma nani
ebuthongweni	e bu thongw eni
siyeka	si yek a
kwayena	kwa ye na
kalula	ka lula
bayibulele	ba yi bulel e
ngamaqushela	ng a ma qush el a
mkhohlisi	m khohl is i
aluphethe	a lu pheth e
umbize	u m biz e
kungachithwa	ku nga chith w a
eze	e z e
zindleko	zin dl ek o
kwakunjalo	kw a ku njalo
akhuleka	a khul ek a
avule	a vul e
wadlubulundela	w a dlubulund el a
simbuyisele	si m buy is el e
babenendlela	ba be n e n dlela
ukumthola	u ku m thol a
egulile	e gul ile
abona	a bon a, a bo na
abone	a bon e
ashikenaze	ashikenaze
emhlane	e m hlane
uyahlaba	u ya hlab a
lukamamncube	luka ma m ncube
umlabalaba	u m labalaba
uzethu	u zethu
ngazo	nga zo
akwenziwa	a kw enz iw a
wegolide	w e golide
ngamakhala	ng a ma khala
ngaze	ng a ze
yizithunzi	y i zi thunzi
ngasale	ng a sal e
izilimi	i zi limi
yokudineka	y o ku din ek a
singakanani	s i ngakanani
uzoxola	u zo xol a
lulokhu	lulokhu
wadi	wadi
umamlaba	u ma mlaba
usishiya	u si shiy a
yobukhosi	y o bu khosi
esingenamkhuba	e si nge na m khuba
wakhuluma	w a khulum a
uzodlula	u zo dlul a
mehluko	m ehluk o
ngisizeni	ngi siz e ni
yomlungu	y o m lungu
kokupheka	k o ku phek a
ayatholakala	a ya thol akal a
yaya	y a y a
usazobuya	u sa zobuy a
isigqabo	i si gqab o
waphela	w a phel a
yayo	ya yo
sokela	sok el a
angibange	a ngi bang e
ngalamazwi	nga la ma zwi
waqala	w a qal a
ezisola	e zi sol a
yilona	yi lo na
waphefumula	w a phefumul a
yizinto	y i zin to
zibulalane	zi bulal an e
engayibuzi	e nga yi buz i
ekhumbule	e khumbul e
okhuleni	o khul eni
imizuzu	i mi zuzu
asisaphefumuli	a si sa phefumul i
ngimbukisise	ngi m buk isis e
wayegange	w a ye gang e
ngingasawaboni	ngi nga sa wa bon i
lokhukuhlamuka	lo khu ku hlamuk a
ayikhombise	a yi khomb is e
kabe	ka be
indima	i n dima
usathenga	u sa theng a
indlu	i n dlu
waqhweba	w a qhweb a
ebesiyomngcwaba	e be si yo m ngcwab a
nginyathela	ng i nyathela, ngi nyathel a
belidla	be li dl a
lezinkukhu	l e zin kukhu
mntanami	m ntana mi, m ntan a mi
waqhubeka	w a qhub ek a
bephelela	be phel el a
watabalasa	w a tabalas a
namaphela	n a ma phela
yaseyideni	y aseyideni
ngaphandle	nga phandle
kuzofuneka	ku zo fun ek a
mnu	mnu
nangu	nan gu
nango	nan g o
wasibingelela	w a si bingelel a
ngalelo	nga le l o
uyagcizelela	u ya gcizel el a
ongamvusa	o nga m vus a
ibheda	i bhed a
ngisiphikise	ngi si phik is e
kungashiwo	ku nga sh iw o
okuthile	o ku th ile
zingamawundlu	zi ng a ma wundlu
bahlabe	ba hlab e
abuya	a buy a
ijulukiswa	i juluk is w a
bayathetha	ba ya theth a
kuhlakazeka	ku hlakaz ek a
esiyomfica	e si yo m fic a
eziphikisa	e zi phik is a
kwakungasamcindezele	kw a ku nga sa m cindez el e
uzama	u zam a
baphathiswe	ba phath is w e
ukomvakashela	u ko m vakashel a
nkilimane	nkilimane
baphuma	ba phum a
nesiguli	n e si gul i
baphume	b a phum e, ba phum e
luncane	lu ncane
imfiva	i m fiva
zisaphila	zi sa phil a
ngizogawula	ngi zo gawul a
uyamchwensa	u ya m chwens a
otom	o tom
okomuntu	o k o mu ntu
engingezibale	e ngi nge zi bal e
ayengayazi	a ye nga y azi
kabayingeni	ka ba yi ngen i
bayovuka	ba yo vuk a
indoda	i n doda
ongakuvimba	o nga ku vimb a
abakufuni	a ba ku fun i
nalaba	na la ba
ngizame	ngi zam e
nalabo	na la b o
ngizama	ngi zam a
izikhwama	i zi khwama
bengizincokolela	be ngi zi ncokol el a
asazi	a s azi
lwaluzozingenela	lw a lu zo zi ngen el a
ikwakhe	i kw akh e
acwala	a cwal a
ungunkalimba	u ng u nkalimba
okuyiphinda	o ku yi phind a
umnikelo	u m nik el o
yilanga	y i langa
iyini	i yi ni
siyayibona	si ya yi bon a
eyindoda	e y i n doda
nenkokhelo	n e n kokhel o
umlenze	u m lenze
ngiyobaxosha	ngi yo ba xosh a
zibulewe	zi bule w e
sebehlobe	se be hlob e
isithukuthele	i si thukuthel e
wawuyibonephi	w a wu yi bon e phi
sesixoxa	se si xox a
ubusejubaneni	u b u se juban eni
akabona	a ka bo na
mali	mali
akaboni	a ka bon i
sekushisekile	se ku sh is ek ile
uqonde	u qond e
nezinyawo	n e zi nyawo
sike	si ke
zisele	zi sel e
nekadadewabo	n e ka dade wa bo
ahlabayo	a hlab a yo
wazilanda	w a zi land a
kolimi	k o limi
azokuba	a zo ku b a
ngizokwazi	ngi zo kw azi
angaphaphama	a nga phapham a
kwenziwani	kw enz iw a ni
esebuyile	e se buy ile
ayiphinde	a yi phind e
ngiyaklatshelwa	ngi ya klatsh el w a
nokumshaya	n o ku m shay a
ngokulithunzi	ng o ku lithunzi
ngingakuphatha	ngi nga ku phath a
eyayisalindelekile	e y a yi sa lind el ek ile
wayengasasikhulumi	w a ye nga sa si khulum i
saxoxa	s a xox a
ngasendlini	nga se ndl ini
kuzofanela	ku zo fanel a
bahola	ba hol a
kwanongoma	kwa no ngoma
ngalesisikhathi	nga le si si khathi
ugovu	u govu
samgeza	s a m gez a
ongawela	o nga wel a
yethu	y ethu
uligqibile	u li gqib ile
eyase	e y a se
kushwelezwe	ku shwelez w e
wagqunqa	w a gqunq a
yithemba	y i themba
seziyashesha	se zi ya shesh a
yibo	yi bo
khehlehle	khehlehle
xola	xol a
ukedorlawomere	u kedorlawomere
angawunyakazisa	a nga wu nyakaz is a
nokufulathela	n o ku fulathel a
kabhanana	ka bhanana
yokuhlala	y o ku hlal a
uthe	u th e
waseposini	wa se pos ini
kakulungile	ka ku lung ile
yathi	y a thi
lamanzi	l a ma nzi
basikhombisa	ba si khomb is a
ulunya	u luny a
usebonwe	u se bon w e
nimtshele	ni m tshel e
ubiza	u biz a
umphongolo	u m phongolo
kugezwa	ku gez w a
kugezwe	ku gez w e
ngomakoti	ng o makoti
othisha	o thisha
kunkk	ku n kk
wacela	w a cel a
wahle	w a hle
ngubani	ng u bani
ugoduke	u goduk e
esihambini	e si hamb ini
mazibuko	ma zibuko
angavuma	a nga vum a
sekuwucu	se ku w u cu
likade	likade
abathunjiwe	a ba thunj iw e
engalambi	e nga lamb i
katom	ka tom
lingazinqumela	li nga zi nqum el a
bazokhuluma	ba zo khulum a
azikhuluma	a zi khulum a
ayeke	a yek e
induna	i n duna
muthi	mu thi
kwesihloko	kw e si hloko
ingakwesikababa	i nga kw e sika baba
azinikwe	a zi nik w e
awazange	a w a zang e
nenkosi	n e n kosi
mdala	m dala
yimpelesi	yimpelesi
ngizele	ngi z el e
buhle	bu hle
bayalibala	ba ya libal a
akathanga	a ka th anga
ngesongwana	ng e songw ana
wazofika	w a zo fik a
sifinyelele	si finyel el e
ngingekuhumushe	ngi nge ku humush e
ozodinga	o zo ding a
bengaka	be ngaka
befika	be fik a
njengomakhonya	njeng o ma khonya
ngizokuza	ngi zo ku z a
sesihambile	se si hamb ile
nohlelo	n o hlel o
eniyenzayo	e ni y enz a yo
wayesephathiswa	w a ye se phath is w a
angazingcolisi	a nga zi ngcol is i
yayihamba	y a yi hamb a
iyona	i yo na
ngakhona	nga kho na
wasezitendeni	w a se zi tend eni
noma	noma
isibongo	i si bong o
ngibuza	ngi buz a
siyaziphumela	si ya zi phum el a
babulale	ba bulal e
akanangqando	a ka na n gqand o
ingozi	i n gozi
kasikho	ka si kho
nomuzi	n o mu zi
sengithinteka	se ngi thint ek a
kwakungupagiyeli	kw a ku ng u pagiyel i, kw a ku ng u pagiyeli
kwakungeke	kw a ku ngeke
uyahlekisa	u ya hlek is a
umbobo	u m bobo
okwebutho	o kw e buth o
engilethe	e ngi leth e
ufunani	u fun a ni
ngacela	ng a cel a
ifundwa	i fund w a
ngiyaqhaqhazela	ngi ya qhaqhaz el a
kokuduma	k o ku dum a
yiwona	yi wo na
benamahloni	be n a ma hloni
kumbelwe	ku mb el w e
ukuphenduka	u ku phenduk a
esengithanda	e se ngi thand a
yalezi	ya le zi
bha	bha
sizobuye	si zo buye
bhe	bhe
sibakhombe	si ba khomb e
waqutshulwa	w a qutshul w a
kulendawo	ku le n dawo
abangase	a ba nga se
ngangibatshelile	ng a ngi ba tshel ile
nalokho	na lo kh o
bhu	bhu
ibhola	i bhola
iwaso	i wa so
bekhona	be kho na
bathumele	ba thum el e
kwadalwa	kw a dal w a
wayengasabheki	w a ye nga sa bhek i
usuyangithanda	u s u ya ngi thand a
bengatholakala	be nga thol akal a
zikhalele	zi khalel e
yawo	ya wo
kwentaba	kw e n taba
yavele	y a vel e
kumcasule	ku m casul e
libathutha	li ba thuth a
makubhotshozwe	ma ku bhotshoz w e
okushiwo	o ku sh iw o
ngezimpande	ng e zim pande
abekade	a be kade
uyebolekile	u ye bolek ile
yilolu	yilolu
tshela	tshel a
uphikelele	u phikelel e
kwenye	kw e nye
eyamxaka	e y a m xak a
ezikhalini	e zi khal ini
ngangingasathandi	ng a ngi nga sa thand i
ngezinsuku	ng e zin suku
basabonakala	ba sa bon akal a
lwambamba	lw a m bamb a
yenzani	y enz a ni
yeka	yek a
lokho	lo kh o
adumbe	a dumb e
kade	ka de
lokhu	lo khu
ukuzwisisa	u ku zw isis a
esethi	e se thi
ngamuzwa	ng a mu zw a
ngimlandela	ngi m landel a
sazibala	s a zi bal a
kwalo	kwa lo
ejahe	e jah e
ukucula	u ku cul a
beqondana	be qond an a
kwale	kwa le
kangazi	ka ng azi
esewatholile	e se wa thol ile
likhomba	li khomb a
sokuba	s o ku b a
ngensini	ng e n sini
lokuthi	l o kuthi
iculo	i cul o
wawabona	w a wa bon a
kwazise	kw a zi s e
sasindwa	s a sind w a
ngoke	ngoke
indwangu	i n dwangu
uzilile	u zi lil e
ngalena	nga le na
umntanomuntu	u m ntan o mu ntu
seyiphumile	se yi phum ile
abeseduze	a be se duze
bekuyikunibikela	be ku yi ku ni bik el a
angaqedi	a nga qed i
babulalane	ba bulal an e
angaqeda	a nga qed a
wenzela	w enzel a
ayisakhululekile	a yi sa khulul ek ile
sengingazikholisa	se ngi nga zi khol is a
sehlukane	s ehluk an e
kwakuye	kw a ku y e
nakunkosazana	na ku n kos az ana
kuzodingaka	ku zo dingak a
nosheleni	n o sheleni
ngiyoye	ngi yo y e
insini	i n sini
lase	la se
esebuqamana	e se buqamana
uzace	u zac e
umdala	u m dala
yokukholwa	y o ku khol w a
emshadweni	e m shad w eni
sengiyi	se ngi yi
bashonaphi	ba shon a phi
esehwaqabele	e se hwaqabel e
angibazi	a ngi baz i
ngiyakubona	ngi ya ku bon a
engamvimba	e nga m vimb a
amawundlu	a ma wundlu
endabeni	e n dab eni
kwensizwa	kw e n sizwa
masinyane	masinyane
angayenzela	a nga y enz el a
imbulumakhasana	i m bulu ma khas ana
sizwe	si zwe
sizwa	si zw a
uzokwenzenjani	u zo kw enz e njani
waqhathwa	w a qhath w a
obakhe	o ba kh e
uyogcina	u yo gcin a
funa	fun a
mdadlana	m dadl ana
sekuvalwa	se ku val w a
kuvulande	ku vulande
ngesikweletu	ng e si kweletu
uzihlabe	u zi hlab e
kuxuxuzele	ku xuxuz el e
sisathuswe	si sa thus w e
yonozulazulane	y o n o zulazul ane
epimville	e pimville
ubekade	u be kade
alishisi	a li sh is i
okunyakazayo	o ku nyakaz a yo
ngiyamangala	ngi ya mangal a
wasuka	w a suk a
ngenye	ng e nye
ami	a mi
kuthunywa	ku thuny w a
muva	muva
ungamtshela	u nga m tshel a
ngangiyikhuluma	ng a ngi yi khulum a
bebona	be bon a
lonesi	lo nesi
ngohambo	ng o hamb o
zisenenkungu	zi se n e n kungu
engahambisani	e nga hamb is an i
bengaqondile	be nga qond ile
selimtholile	se li m thol ile
njengayizolo	njenga yizolo
limqhoqhobele	li m qhoqhobel e
okwakufanele	o kw a ku fan el e
uphathanisela	u phathanisel a
ekhuluma	e khulum a
lokushiya	l o ku shiy a
kwatholakala	kw a thol akal a
eseguge	e se gug e
lasegoli	la se goli
nabo	na bo
izinsizwa	i zin sizwa
esephetha	e se pheth a
impahla	i m pahla
ligcine	li gcin e
ukudepha	u ku deph a
ikhanda	i khanda
ubhekisisile	u bhek isis ile
lizikhalela	li zi khal el a
wayethi	w a ye thi
uthando	u thand o
unganiguleli	u nga ni gul el i
olulokhu	o lu lokhu
ezobukhosi	e z o bu khosi
uthanda	u thand a
uligodle	u li godl e
ngokugxila	ng o ku gxil a
ungabhala	u nga bhal a
owathanda	o w a thand a
ulibele	u libel e
ngafunga	ng a fung a
ukuyifunisisa	u ku yi fun isis a
ngangiphupha	ng a ngi phuph a
emabhokwini	e ma bhokw ini
kwakuthi	kw a ku thi
kuphakame	ku phakam e
wewu	wewu
sime	si m e
ngizokusiza	ngi zo ku siz a
simo	si mo
lamabutho	l a ma buth o, la ma buth o
okwakuhlezi	o kw a ku hlez i
ukukuzonda	u ku ku zond a
udlale	u dlal e
wakhathala	w a khathal a
kamkhize	ka mkhize
liyozilinganisa	li yo zi lingan is a
shwi	shwi
usakukhumbula	u sa ku khumbul a
bangehlukaniselana	ba ng ehlukan is el an a
bezindaba	b e zin daba
walotsholwa	w a lotshol w a
ngaqala	ng a qal a
ikamelo	i kamelo
angiphathe	a ngi phath e
d	d
yikhanda	y i khanda
kombhede	k o m bhede
nento	n e n to
iseka	i sek a
zithothombele	zi thothombel e
abahambi	a ba hamb i
kwakude	kwa ku de
bayangena	ba ya ngen a
azolutshela	a zo lu tshel a
ngingamsiza	ngi nga m siz a
kwedwala	kw e dwala
ngaziduduza	ng a zi duduz a
selicabanga	se li cabang a
bobabili	bo ba bili
bayamnqoba	ba ya m nqob a
ngiyozwa	ngi yo zw a
ngaphambili	nga phambili
kwaso	kwa so
lencwadi	l e n cwadi
lalimthatha	l a li m thath a
kafaro	ka faro
bengemuva	be ng emuva
kudlula	ku dlul a
kudlule	ku dlul e
eshela	e shel a
libathufelele	li ba thufel el e
be	be
qala	qal a
yonyazi	y o nyazi
bo	bo
izithupha	i zi thupha
wasala	w a sal a
zithule	zi thul e
untombazi	u ntomb azi
aswele	a swel e
lusuku	lu suku
belivula	be li vul a
okwamanjena	o kwa manje na
yilowo	yi lo w o
ngisaphinde	ngi sa phind e
ngalendaba	nga le n daba
ngisaphinda	ngi sa phind a
yaqonda	y a qond a
sondela	sondel a
akasheshanga	a ka shesh anga
uyongedusa	u yo ng edus a
kwakubuye	kw a ku buy e
emhlabeni	e m hlab eni
kasibuzi	ka si buz i
kulengonyama	ku le n go nyama
wazibona	w a zi bon a
igxumele	i gxum el e
ebese	e be se
ekhumula	e khumul a
into	i n to
waquleka	w a qul ek a
kubuphi	ku bu phi
kaningi	ka ningi
kuzo	ku zo
esebiza	e se biz a
ngokunikina	ng o ku nikin a
osengcono	o se ngcono
kuyaluzwa	ku ya lu zw a
lithe	li th e
usukhule	u s u khul e
lenkulunkahla	l e n kulunkahla
lithi	li thi
omusha	o mu sha
ungangizwisisi	u nga ngi zw isis i
intombi	i n tomb i
uyazibonela	u ya zi bon el a
ngezincwadi	ng e zin cwadi
kunani	kuna ni
sekusele	se ku s el e
ubone	u bon e
kwakuhlezi	kw a ku hlez i
ubona	u bon a
ayeseqala	a ye se qal a
ukuminyana	u ku miny an a
uzomangala	u zo mangal a
kwashaqeka	kw a shaq ek a
wahleka	w a hlek a
sihlezi	si hlez i
amanqe	a ma nqe
udlula	u dlul a
impi	i m pi
kagumede	ka gumede
wokuthi	w o kuthi
ulingana	u ling an a
eqhamuka	e qhamuk a
inkomo	i n komo
ozobona	o zo bon a
nesinqumo	n e si nqum o
wokuba	w o kuba
anqandeke	a nqand ek e
kukhanyile	ku khanyil e, ku khany ile
unawo	u na wo
ngiyasho	ngi ya sho
yokosa	y o k os a
ingasekho	i nga se kho
lesikholwa	l e si khol w a
selifikile	se li fik ile
hleze	hleze
unosimilo	u n o si mil o
ababekhona	a ba be kho na
sabantwana	s a ba ntw ana, s a ba ntwana
engizociba	e ngi zo cib a
ezintabeni	e zin tab eni
lilokhu	li lokhu
baqhubekele	ba qhub ek el e
basale	b a sal e, ba sal e
abashova	a ba shov a
bekungafanele	be ku nga fanel e
udumisani	u dumisani
kuhlangane	ku hlangan e
street	street
balubeke	b a lu bek e
angizange	a ngi zange
ngingabukela	ngi nga buk el a
sibanjwe	si banj w e
ibatshela	i ba tshel a
adonselwa	a donsel w a
obokufa	o b o ku f a
unebhandishi	u n e bhandishi
wathontela	w a thont el a
ningaphumeli	ni nga phum el i
okwamphaphamisa	o kw a m phapham is a
nafezela	na fezela
ngezitebhisi	ng e zi tebhisi
ngiye	ngi y e
nanomuntu	na n o mu ntu
abakatholakali	a ba ka thol akal i
iliqhinga	i li qhing a
yezizathu	y e zi zathu
sasizishayela	s a si zi shay el a
sekunento	se ku n e n to
amabili	a ma bili
bekumele	be ku m el e
kufundwe	ku fund w e
selilengela	se li leng el a
kufundwa	ku fund w a
ungangikhaleli	u nga ngi khalel i
ukuchwensa	u ku chwens a
ukusebenza	u ku sebenz a
ngincome	ngi ncom e
nencu	n e ncu
uyokutshela	u yo ku tshel a
ngekhala	ng e khala
loyindlu	l o y i n dlu
asole	a sol e
wayeseshonisa	w a yese shon is a
lilambile	li lamb ile
asola	a sol a
kabakwazi	ka ba kw azi
sekunomugqa	se ku n o mu gqa
ungabuza	u nga buz a
ngabambelela	ng a bambel el a
ayithathe	a yi thath e
ubuntu	u bu ntu
usaqhubeka	u sa qhub ek a
ukuyichaza	u ku yi chaz a
nxumalo	nxumalo
lentombi	le n tombi
ukweneka	u kw enek a
izindaba	i zin daba
wafike	w a fik e
kwengane	kw e n gane
ayabona	a ya bon a
ukuthini	u ku thi ni
ayephambili	a ye phambili
umuzwe	u mu zwe
udlala	u dlal a
kunyatheliswa	ku nyathel is w a
kukhombisa	ku khomb is a
alandelandele	a landeland el e
kusenjalo	ku se njalo
isicabha	i si cabha
lokuphunyula	l o ku phunyul a
amakhehla	a ma khehla
yomfana	y o m fana
baba	b a b a, baba, ba b a
ubengenjena	u be nge nje na
asecabange	a se cabang e
lumuthi	lu mu thi
babo	ba bo
mpiloni	m pil o ni
umfana	u m fana, u m f ana
udaba	u daba
wayinhlabathi	w ayinhlabathi
ngegazi	ng e gazi
nohluphile	n o hluph ile
baphila	ba phil a
ukuzibuka	u ku zi buk a
sabo	sa bo
uzwide	u zwide
kathathu	ka thathu
zakhuleka	z a khul ek a
sengiphila	se ngi phil a
zafa	z a f a
bagcine	ba gcin e
yasemtshezi	ya se m tshezi
lenxuluma	le n xuluma
isebucayini	i se bucay ini
izokwenekelwa	i zo kw enek el w a
lensangu	l e n sangu, le n sangu
ahlangane	a hlangan e
laliqopha	l a li qoph a
asikho	a si kho
wasivula	w a si vul a
ngesokuhlwa	ng e s o ku hlw a
sekuhwalele	se ku hwal el e
ihlakaniphise	i hlakaniph is e
hawu	hawu
awubange	a wu bang e
oyongcwatshwa	o yo ngcwatsh w a
ngiyobuyela	ngi yo buy el a
ojwayeleka	o jwayel ek a
nezangoma	n e z angoma
limbeka	li m bek a
ngaphansi	nga phansi
sebezihudula	se be zi hudul a
ngiphansi	ngi phansi
zinqwaba	zi nqwab a
edandi	e dandi
ngaphezulu	nga phezulu
ngimemeze	ngi memez e
gozololo	gozololo
ubethe	u beth e
ibulawe	i bulaw e
angake	a nga ke
amlethele	a m leth el e
emapulazini	e ma pulaz ini
iningi	i ningi
kwamanxiwa	kwa ma nxiwa
mhlawumbe	mhlawumbe
ngike	ngi ke
sokudla	s o ku dl a
esitimeleni	e si timel eni
yayithanda	y a yi thand a
bashayisane	ba shay is an e
zombili	zo m bili
balishumi	ba li shumi
niyangizwisa	ni ya ngi zw is a
ngisemvakwabo	ngi se mva kwa bo
ngekhanda	ng e khanda
zibizwa	zi biz w a
ngushaka	ng u shaka
ngithe	ngi th e
kufundisa	ku fund is a
wadla	w a dl a
uqiliga	u qilig a
ngisachitha	ngi sa chith a
ebalandele	e ba landel e
iwashi	i washi
baxoxele	ba xox el e
njengezinto	njeng e zin to
sezisenze	se zi s enz e
abafo	a ba fo
ngemvubu	ng e m vubu
ivuna	i vun a
esiteshini	e si tesh ini
yomdlalo	y o m dlal o
ziyosisiza	zi yo si siz a
kunalokho	kuna lo kh o
kwadliwa	kw a dl iw a
umuthi	u mu thi
libheke	li bhek e
kunalokhu	kuna lo khu
umgcagco	u m gcagc o
akusasizi	a ku sa siz i
iqhubekile	i qhub ek ile
udambuza	u dambuz a
nensizwa	n e n sizwa
echobana	e chob an a
eyingozi	e y i n gozi
esemdala	e se m dala
lungayibambanga	lu nga yi bamb anga
ngumuntu	ng u mu ntu
ebangeni	e bang eni
igcwele	i gcwel e
ezidonsa	e zi dons a
ezimhlophe	e zi mhlophe
ngabanye	ng a ba nye
edolweni	e dolw eni
uzothi	u zo thi
wubuhlakalala	w u bu hlakalala
ukufika	u ku fik a
lishona	li shon a
ngigxawuzele	ngi gxawuz el e
yini	yi ni
wayengakanqwamani	w a ye nga ka nqwaman i
kasizwa	ka sizwa
ayiyi	a yi y i
abantwana	a ba ntwana
ababengazi	a ba be ng az i
ngamphendula	ng a m phendul a
sesigugile	se si gug ile
samakhawa	s a ma khawa
ngovivi	ng o vivi
ezinhlungwini	e zin hlungw ini
ukusiza	u ku siz a
ngiyobheka	ngi yo bhek a
kwenziwe	kw enz iw e
kwenziwa	kw enz iw a
kulendlu	ku le n dlu
yinkehli	y i nkehli
izitsha	i zi tsha
ezinsuku	e zin suku
waphuza	w a phuz a
nakini	na ki ni
angitshele	a ngi tshel e
obecabanga	o be cabang a
uyoshada	u yo shad a
ayengakhishwanga	a ye nga khish w anga
sizokulinda	si zo ku lind a
iceliwe	i cel iw e
akuyona	a ku yo na
akakakwazi	a ka ka kw azi
lokucingisisa	l o ku cing isis a
abathengisele	a ba theng is el e
uzozumeka	u zo zum ek a
yamanye	y a ma nye
lezizimo	le zi zi m o
angawuthola	a nga wu thol a
uthathe	u thath e
uthatha	u thath a
nginezindlela	ngi n e zin dlela
angayiqeda	a nga yi qed a
mangivakashe	ma ngi vakash e
suku	suku
kwabakhanyela	kw a ba khany el a
zayithungela	z a yi thung el a
ukuphikisana	u ku phik is an a
uvakashelaphi	u vakashel a phi
kwethu	kw ethu
bangabantwana	ba ng a ba ntwana
dlamini	dlamini
bengizwele	be ngi zw el e
imfucumfucu	i m fucumfucu
wasichazela	w a si chaz el a
ngizoshonaphi	ngi zo shon a phi
ngisaphila	ngi sa phil a
sokhela	s okhel a
bukajantshi	buka jantshi
babuke	ba buk e
emvusa	e m vus a
kwalelidwala	kwa le li dwala
sasisobabili	s a si so ba bili
wayekuthatha	w a yekuthath a
kuchaza	ku chaz a
ekhaleni	e khal eni
indlovukazi	i n dlovu kazi
ukuqonda	u ku qond a
engenandaba	e nge na n daba
loluphahla	lo lu phahla
katajewo	ka tajewo
ngiyakweluleka	ngi ya kw elul ek a
sajabula	s a jabul a
sikhulu	si khulu
ngokunjalo	ng o ku njalo
noyise	n o yise
olungakuthinta	o lu nga ku thint a
mayimendisele	ma yi m end is el e
uxhume	u xhum e
kulenkosikazi	ku le n kosi kazi
yadliwa	y a dl iw a
akathatheni	a ka thath en i
ndawondawo	ndawo n dawo
ukungihlolela	u ku ngi hlol el a
sendawo	s e n dawo
uthenga	u theng a
wawuthe	w a wu th e
ukhululeke	u khululek e
ngiphumelele	ngi phumel el e
kungashona	ku nga shon a
yabafazi	y a ba fazi
lwezingane	lw e zin gane
sikwethemba	si kw ethemb a
kupotifari	ku potifari
ngiyokuhlenga	ngi yo ku hleng a
ngezintelezi	ng e zin telez i
ukuyojika	u ku yo jik a
wohloka	w o hlok a, wohlok a
sebebabili	se be ba bili
ucingo	u cing o
wayesamile	w a ye sa m ile
lisalwa	li sa lw a
owubuzayo	o wu buz a yo
zinsizwa	zinsizwa
uhlakaniphile	u hlakaniph ile
yase	ya se
ukwesaba	u kw esab a
yaso	ya so
ihlakaniphile	i hlakaniph ile
ukufunda	u ku fund a
ngodadewethu	ng o dade w ethu
nentokozo	n e n tokoz o
ukhuluphele	u khuluphel e
wabheka	w a bhek a
eselifumbethe	e se li fumbeth e
ukudideka	u ku did ek a
emehlweni	e m ehlw eni
kabangeni	ka ba ngen i
ende	e n de
zadedelwa	z a ded el w a
waziduduza	w a zi duduz a
bencenge	be nceng e
angizokubuza	a ngi zo ku buz a
neminyaka	n e mi nyaka
la	la
ulizzy	u lizzy
nasegilonko	na se gilonko
kwakukhohlakaleka	kw a ku khohl akal ek a
ensimini	e n sim ini
isilatini	i si latini
lamangalisa	l a mangal is a
bayizolo	ba y izolo
ngumarony	ng u marony
gebe	gebe
esasihleli	e sa si hlel i
sekuyiphupho	se ku y i phuph o
wawubeka	w a wu bek a
endodeni	e n dod eni
ukuyikhipha	u ku yi khiph a
esinamandla	e si n a ma ndla
uyiliphi	u yi li phi
ngilena	ngi le na
kayiyinhle	ka yi yin hle
izithunzana	i zi thunz ana
eduze	eduze
kuyahlushekwa	ku ya hlush ek w a
phandle	phandle
waphatheka	w a phath ek a
besekwaluseni	be se kwa luseni
sizowuqedela	si zo wu qed el a
emihlanu	e mi hlanu
umpontshi	u m pontshi
ungakwenza	u nga kw enz a
enyangeni	e nyang eni
yisihlahla	y i si hlahla
nebala	n e bala
bayaye	ba ya y e
ngowakhe	ng o wa khe
esesitshele	e se si tshel e
obasondela	o ba sondel a
wabe	w abe
uyeka	u yek a
waba	w a b a
sekuseduze	se ku se duze
nokuciba	n o ku cib a
siphenye	si pheny e
neze	neze
azimela	a zi m el a
ngegama	ng e gama
vo	vo
ifike	i fik e
bebaleke	be balek e
kwaziwe	kw azi w e
sizokwenzenjani	si zo kw enz e njani
ungesaba	u ng esab a
ungesabi	u ng esab i
uboneni	u bon e ni
sengonyama	s e n gonyama
lochitha	l o chitha
vuyiswa	vuy is w a
ukuzwela	u ku zw el a
pho	pho
bale	ba le
eqongqotha	e qongqoth a
ungubani	u ng u bani
esinxeleni	e si nxel eni
uhlohlwa	u hlohl w a
njengonyazi	njeng o n yazi
uwenzeni	u w enz e ni
uyiqhweba	u yi qhweb a
usuvale	u s u val e
ngomlilo	ng o m lilo
abakhombise	a ba khomb is e, a b akhomb is e
uyafihla	u ya fihl a
ukubaqambela	u ku ba qamb el a
usiphuthumise	u si phuthum is e
wayiletha	w a yi leth a
umdlalo	u m dlal o
ezivulela	e zi vul el a
akalindanga	a ka lind anga
ngithi	ngi thi
okufuna	o ku fun a
ngiyizibe	ngi yi zib e
kwaphelela	kw a phel el a
ngezela	ng ezel a
ubengakawufaki	u be nga ka wu fak i
sizokuqulela	si zo ku qulel a
yokulala	y o ku lal a
sezilungisiwe	se zi lung is iw e
bakwenza	ba kw enz a
udadewabo	u dade wa bo
abathwele	a ba thwel e
abacabanga	a ba cabang a
ngokuthanda	ng o ku thand a
onendaba	o n e n daba
bekungamathambo	be ku ng a ma thambo
betshela	be tshel a
bamangala	ba mangal a
nezindlebe	n e zin dlebe
nginemisebenzi	ngi n e mi sebenz i
enza	enz a
nonke	no nke
ladlala	l a dlal a
ubumnyama	u bu mnyama
sibona	si bon a
inqume	i nqum e
imenzakalise	i m enz akal is e
eyodwa	e yo dwa
nanhlanu	na n hlanu
nokumhlanza	n o ku m hlanz a
isikhala	i si khala
emathuneni	e ma thun eni
ngamehlo	ng a me hlo
shono	sho no
kwenzelwe	kw enz el w e
kokwanelisa	k o kw anel is a
kwenzelwa	kw enz el w a
yantambama	ya ntambama
angenzani	a ng enz a ni
wakubona	w a ku bon a
inhlamba	i n hlamba
ungavumi	u nga vum i
ngivumelana	ngi vumel an a
ngakunuka	ng a ku nuk a
lababafana	la ba ba fana
angikutholi	a ngi ku thol i
zihlonipha	zi hloniph a
uzibizele	u zi biz el e
ubopha	u boph a
ungazisobozela	u nga zi soboz el a
siyamemeza	si ya memez a
senzela	s enz el a
kuyena	ku ye na
dakla	dakla
ngihlezi	ngi hlez i
zakho	za kho
abazenzi	a ba z enz i
bunomusa	bu n o mu sa
wakhala	w a khal a
sengibonga	se ngi bong a
zakhe	za khe
nokungethembeki	n o ku ng ethemb ek i
ubuthi	u bu thi
amathathu	a ma thathu
ubutha	u bu tha
owayengaba	o w a ye nga b a
okotshani	o k o tshani
umangubane	u mangubane
wangibuka	w a ngi buk a
izinduna	i zin duna
sebengiphendukele	se be ngi phenduk el e
ungichazela	u ngi chaz el a
bakhuluma	ba khulum a
bengalali	be nga lal i
njengokuthatha	njengo ku thath a
zigqoma	zi gqom a
okwangalesosikhathi	o kwa nga le s o si khathi
izimbuzi	i zim buzi
izizathu	i zi zathu
ilungile	i lung ile
naleyongane	na le y o n gane
nezimpondo	n e zim pondo
sengophe	se ng oph e
kusethawuleni	ku se thawul eni
ukwala	u kw al a
yilo	yi lo
ina	i n a
ngakhulekela	ng a khul ek el a
ubugebengu	u bu gebengu
ngiyifuna	ngi yi fun a
kabathandi	ka ba thand i
kwamabili	kw a ma bili
unozimanga	u n o zi manga
akasethathwe	a ka se thath w e
ngangilithatha	ng a ngi li thath a
abesibeke	a b e si bek e
kwathathwa	kw a thath w a
lizobalibi	li zo b a li bi
kuphilwa	ku phil w a
kuyiphunyuka	ku yi phunyuk a
ngiyomenza	ngi yo m enz a
kanje	ka nje
kungakakhulunywa	ku nga ka khuluny w a
engakhumuzeki	e nga khumuz ek i
ikhishi	ikhishi
imlandisa	i m land is a
linikeza	li nikez a
seligqunqe	se li gqunq e
ngiyozikhunga	ngi yo zi khung a
siqalephi	si qal e phi
ulingene	u ling en e
ongalena	o nga le na
usikhuni	u si khuni
kokungabaza	k o ku nga baz a
bekuyizolo	be ku y izolo
ngazibuza	ng a zi buz a
leliya	le li ya
ukumbheka	u ku m bhek a
ukuyilanda	u ku yi land a
uzophaphama	u zo phapham a
uchaze	u chaz e
kuyacaca	ku ya cac a
sabamba	s a bamb a
ngoqhotho	ng o qhotho
konakele	k on akel e
bangiqamba	ba ngi qamb a
engayifundi	e nga yi fund i
elizayo	e li z a yo
angiyifuni	a ngi yi fun i
uboysie	u boysie
umfo	u m fo
ngokuzama	ng o ku zam a
asengizonda	a se ngi zond a
ngezamaqhawe	ng e z a ma qhawe
ngoduma	ng o duma
wazibuza	w a zi buz a
obehlela	o be hlel a
amahlanu	a ma hlanu
wayithanda	w a yi thand a
iloli	i loli
wayolunguza	w a yo lunguz a
sengithe	se ngi th e
nakho	na kh o
ngizohlanganisa	ngi zo hlangan is a
sengithi	se ngi thi
ezilile	e zi lil e
nakhu	na khu
izinsukwana	i zin sukw ana
ozayo	o z a yo
ibuzwa	i buz w a
womgexo	w o m gexo
uyalazi	u ya l azi
walanda	w a land a
ngabe	ngabe
uholelwa	u hol el w a
egugwini	e gugw ini
zikanokusho	zika no ku sho
wamshumpula	w a m shumpul a
mabaxoshwe	ma ba xosh w e
kwakukhona	kw a ku kho na
kungemakhaza	ku nge makhaza
ake	ake
inkunzi	i n kunzi
yompucuko	y o m pucuk o
wawungaqondanga	w a wu nga qond anga
lendlovukazi	l e n dlovu kazi
abaphe	a ba ph e
esangweni	e sangw eni
angiboni	a ngi bon i
usayicabanga	u sa yi cabang a
kuzobola	ku zo bol a
zokuhambisa	z o ku hamb is a
kabani	ka bani
sekonakele	se k on akel e
akusavumi	a ku sa vum i
abizwe	a biz w e
kulikolikoza	ku liko likoz a
enje	e nje
iyolanda	i yo land a
linamasi	li n a ma si
enzima	e nzima
ingazi	i ng azi
ibulale	i bulal e
klwi	klwi
ushoti	u shot i
angezi	a ng ez i
bayinkinga	ba y i n kinga
okusemoyeni	o ku se moy eni
bafanelana	ba fan el an a
bakwajosefa	ba kwa josefa
wayofunani	w a yo fun a ni
ezelwe	e zel w e
kudida	ku did a
sizosizakala	si zo siz akal a
uqaphele	u qaphel e
kwabe	kw a b e
kwaba	kw a b a
zihle	zihle
seyibabizile	se yi ba biz ile
zimumethe	zi mumeth e
kwabo	kwa bo
azomkhulekela	a zo m khul ek el a
limkhomba	li m khomb a
ibabonile	i ba bon ile
wakukhohlwa	w a ku khohl w a
kwaconsa	kw a cons a
angidonswanga	a ngi dons w anga
balemukela	ba l emuk el a
athathe	a thath e
kulukhuni	ku lukhuni
wangibuza	w a ngi buz a
izomehlula	i zo m ehlul a
yaqhwisha	y a qhwish a
axoxe	a xox e
wabingelela	w a bingelel a
awekho	a w ekho
unhlengethwa	u nhlengethwa
bammbela	ba m mb el a
engome	e ngom e
ngenhliziyo	ng e n hliziyo
usabuya	u sa buy a
uzokhala	u zo khal a
insika	i n sika
nondlela	n o n dlela
ngesipikiyana	ng e si pikiy ana
yodwa	yo dwa
sekuzokusa	se ku zo ku s a
ungathi	u nga thi
safa	s a f a
bexhunywe	be xhuny w e
bayofika	ba yo fik a
wayehlezi	w a ye hlez i
isibhedlela	i si bhedlela
bani	bani
izingane	i zin gane
izinyawo	i zi nyawo
banezinduna	ba n e zin duna
mehlo	me hlo
lakithi	la ki thi
zabo	za bo
zabe	z a b e, z ab e
ngikhuluma	ngi khulum a
okusizayo	o ku siz a yo
nesokuxoxa	n e s o ku xox a
ushiye	u shiy e
ngisakhathele	ngi sa khathel e
izimfanelo	i zim fan el o
sengidelile	se ngi del ile
esephindaphinda	e se phind a phind a
uyamvikela	u ya m vik el a
uzophuma	u zo phum a
ukukhunjuzwa	u ku khunjuz w a
egibithe	e gibithe
kwakunganakiwe	kw a ku nga nak iw e
yezilimi	y e zi limi
ubhasikidi	u bhasikidi
ebuhlungu	e buhlungu
nginemali	ngi n e mali
asabe	a sab e
wasimze	w a simze
ngakhumbula	ng a khumbul a
kusetshenzwe	ku setshenz w e
nezidumile	n e zi dum ile
namapotimende	n a ma potimende
ebhasini	e bhas ini
kufinyaniseke	ku finyan is e ke
wagcwala	w a gcwal a
ngikhonzeleni	ngi khonz el e ni
ngibahlupha	ngi ba hluph a
kokusebenzisa	k o ku sebenz is a
kwakuze	kw a ku z e
kukhanye	ku khany e
nabantwana	n a ba ntwana, n a ba ntw ana
okungesiyona	o ku nge si yo na
kwammisa	kw a m mis a
zangena	z a ngen a
izinqola	i zin qola
wafikelwa	w a fik el w a
yizona	yi zo na
unengalo	u n e n galo
useyasukuma	u se ya sukum a
kuphi	ku phi
bamila	ba mil a
nezitha	n e zi tha
ungangenzi	u nga ng enz i
esenqotshiwe	e se nqotsh iw e
efilidi	e filidi
esekhona	e se kho na
kwesango	kw e sango
angakapholi	a nga ka phol i
anginamali	a ngi na mali
angamshaya	a nga m shay a
umthetho	u mthetho
lezozinto	le z o zin to
sawabona	s a wa bon a
ulifundile	u li fund ile
impilo	i m pil o
zikhathele	zi khathel e
bebe	be b e
yangiphazamisa	y a ngi phazam is a
wasikhokhela	w a si khokh el a
nibona	ni bon a
ukusola	u ku sol a
alomisile	a lom is ile
igama	i gama
abafuna	a ba fun a, a b a fun a
umthamo	u m thamo
ayesebenza	a ye sebenz a
ezihlathini	e zi hlath ini
lula	lul a
yakhohlakala	y a khohl akal a
siseyizitha	si se y i zi tha
eyithulisa	e y ithul is a
angigculiswa	a ngi gcul is w a
ishunqa	i shunq a
zimbi	zim bi
awuqambi	a wu qamb i
alale	a lal e
inkentshane	i n kentshane
sizokufundisa	si zo ku fund is a
sishishilize	si shishiliz e
enquthu	e nquthu
meromo	meromo
ukumluma	u ku m lum a
utajewo	u tajewo
izinsuku	i zin suku
kubiza	ku biz a
ongasonti	o nga sont i
ayozibongela	a yo zi bong el a
usunje	usunje
umugqa	u mu gqa
ihluthule	i hluthul e
ukubonana	u ku bon an a
kunqwaha	ku nqwah a
nalena	na le na
gwababa	gwababa
ukuhamba	u ku hamb a
okobuso	o k o bus o
abangazange	a ba nga zange
akasenakubuya	a ka se na ku buy a
elingumamba	e li ng u mamba
inyanga	i nyanga
eyagcwala	e ya gcwal a
amabutho	a ma buth o
angiyiqondi	a ngi yi qond i
lokuxolisa	l o ku xol is a
liyabatshela	li ya ba tshel a
ephenya	e pheny a
bayithanda	ba yi thand a, b a yi thand a
yomoya	y o moya
ngimqhatha	ngi m qhath a
du	du
lesi	le si
namafutha	n a ma futha
oweqela	o w eq el a
kwacweba	kw a cweb a
eliyinto	e li y i n to
ukuma	u ku m a
emi	e m i
kungeyezikhulu	ku ng e y e zi khulu
esesho	e se sho
bagadwe	ba gad w e
nasembumbulu	na se mbumbulu
untombini	u n tombi ni
ngingayibhalisa	ngi nga yi bhal is a
eningayithola	e ni nga yi thol a
angene	a ngen e
ukwazi	u kw azi
ukhamba	u khamba
levodka	l e vodka
ukufundisa	u ku fund is a
mabaholwe	ma ba hol w e
ngikuzwa	ngi ku zw a
omnyama	o mnyama
nyanga	nyanga
babengasasithakaseli	ba be nga sa si thakas el i
ihlale	i hlal e
we	we
awushude	a wu shud e
wo	wo
sekumele	se ku m el e
baphendule	ba phendul e
ozokhathazeka	o zo khathaz ek a
ukovakashela	u ko vakashel a
isiya	i s i y a
ukuphuma	u ku phum a
isiye	i s i y e
sengaphupha	se ng a phuph a
wabuka	w a buk a
qwayi	qwayi
okhulekayo	o khul ek a yo
ukubumbeka	u ku bumb ek a
kungafiwa	ku nga f iw a
udolly	u dolly
ningamagwala	ni ng a ma gwala
isithembu	i si thembu
esejulukiswa	e se juluk is w a
bayigqibela	ba yi gqibel a
babika	ba bik a
ukutholakala	u ku tholakal a
oqhuma	o qhum a
ukungena	u ku ngen a
kuligwala	ku li gwala
ongizalayo	o ngi zal a yo
uzomthola	u zo m thol a
nomahhohlohhohlo	n o ma hhohlo hhohlo
ngizobheka	ngi zo bhek a
ulengisa	u leng is a
sekukade	se ku kade
kayinasikhathi	ka yi na si khathi
abakabuthwa	a ba ka buth w a
akuzange	a ku zange
imihlola	i mi hlola
impicabadala	i m pic a ba dala
ngokushabalala	ng o ku shabalal a
akusizanga	a ku siz anga
akunjena	a ku nje na
ongalungile	o nga lung ile
ukuyibona	u ku yi bon a
elihle	e li hle
bazokulwa	ba zo ku lw a
usungabona	u s u nga bon a
usipho	u si ph o
elalibuka	e l a li buk a
ziningi	zi ningi
nemali	n e mali
avamise	a vamis e
nocela	n o cel a
kushuduzwe	ku shuduz w e
ujahile	u jah ile
esitolo	e si tolo
kazisakunakile	ka zi sa ku nak ile
sekuhlahle	se ku hlahl e
sivulele	si vul el e
sakhe	sa khe
bazoke	ba zo ke
bazoyiphatha	ba zo yi phath a
esikoleni	e si kol eni
sakho	sa kho
umbelesele	u m belesel e
zijaha	zi jah a
zizolunga	zi zo lung a
zalukazi	z alu kazi
owayemsize	o w a ye m siz e
ibhubesi	i bhubesi
phumani	phum a ni
ukukwenza	u ku kw enz a
thu	thu
ngingajabula	ngi nga jabul a
kayisekho	ka yi se kho
kunotom	kun o tom
nomuntu	n o mu ntu
kugitshelwa	ku gitshel w a
emfume	e mfume
makathule	ma ka thul e
abitoze	a bitoz e
ngiyabonga	ngi ya bong a
ayikamethembi	a yi ka m ethemb i
ameme	a mem e
ngiphindele	ngi phind el e
ubonani	u bon a ni
icabanga	i cabang a
ushonile	u shon ile
imigqa	i mi gqa
ngayibona	ng a yi bon a
ngakhela	ng akh el a
nguthisha	ng u thisha
leyomithi	le y o mi thi
enamathambo	e n a ma thambo
maye	maye
useyifundile	u se yi fund ile
elalihamba	e l a li hamb a
uvula	u vul a
ababeke	a ba bek e
silahle	si lahl e
ibehlele	i be hlel e
bangamboni	ba nga m bon i
kwahlwa	kw a hlw a
kuphathwa	ku phath w a
satholana	s a thol an a
ngiyeka	ngi yek a
ngiyeke	ngi yek e
altare	altare
yabangwa	y a bang w a
ubhekile	u bhek ile
kweso	kw e so
bahlala	ba hlal a
zisashaywa	zi sa shay w a
kuyadabukisa	ku ya dabuk is a
wazinza	w a zinz a
emibili	e mi bili
sengihlabene	se ngi hlab en e
yiqiniso	y i qinis o
kulelihlathi	ku le li hlathi
ngumbhulelo	ng u m bhul el o
umasibisi	u masibisi
eqinisweni	e qin is w eni
akhohlwe	a khohl w e
nedlulisele	n edlul is el e
lubasiza	lu ba siz a
esaphila	e sa phil a
indawo	i n dawo
bayakubalekela	ba ya ku balekel a
esehlezi	e se hlez i
yesibili	y e si bili
sikubona	si ku bon a
ungathola	u nga thol a
onganyamalala	o nga nyamalal a
bebemcuphile	be be m cuph ile
bazobona	ba zo bon a
ethule	e thul e
asethuse	a s ethus e
amathoshi	a ma thoshi
okuqhubekayo	o ku qhub ek a yo
ikhefu	i khefu
ngenzeni	ng enz e ni
siyakuthanda	si ya ku thand a
esaqede	e sa qed e
abhalisele	a bhal is el e
bangayiphazamisi	ba nga yi phazam is i
intoni	i n toni
izithonto	i zi thont o
sekhaya	se khaya
wayengaboni	w a ye nga bon i
lokhuya	lo khu ya
uyawabuka	u ya wa buk a
zisekhona	zi se kho na
angibambela	a ngi bamb el a
etafuleni	e taful eni
lesosikhathi	le s o si khathi
asezisefweni	a se zi sefw eni
yaseqhudeni	ya se qhud eni
iduku	i duku
sikanina	sika nina
ngizomfica	ngi zo m fic a
osefile	o se f ile
ihlangene	i hlangen e
lezizinto	le zi zin to
yetafula	y e tafula
nakwamanye	n a kw a ma nye
umculo	u m cul o
kuyokusa	ku yo ku s a
yilapho	yi lapho
ngakulahla	nga ku lahl a
ngangingengedwa	ng a ngi nge nge dwa
ayiwela	a yi wel a
yilapha	yi lapha
ukuvuka	u ku vuk a
nanye	na nye
akukhumbule	a ku khumbul e
kayikho	ka yi kho
uyancishana	u ya ncish an a
owabulala	o w a bulal a
wayengaphila	w a ye nga phil a
ngalazi	ng a l azi
yokuhamba	y o ku hamb a
abangazazi	a ba nga zaz i
esexoshwe	e se xosh w e
nihlale	ni hlal e
zanqwabelana	z a nqwabel an a
endleleni	e n dlel eni
nixoxa	ni xox a
onje	o nje
ubekwa	u bek w a
ndodana	n dod ana
ngokuba	ng o ku b a
abesesizakele	a be se si zakele
ongenakuphikwa	o nge na ku phik w a
kabalethi	ka ba leth i
ukuphazanyiswa	u ku phazany is w a
uqhamuka	u qhamuk a
ngilinde	ngi lind e
nagqubu	na gqubu
wanikela	w a nik el a
abavame	a ba vam e
ozomelwa	o zo m el w a
ngagana	ng a gan a
uyowuthathaphi	u yo wu thath a phi
impumelelo	i m pumelel o
nakubheka	na ku bhek a
nozwide	n o zwide
yakwabo	ya kwa bo
sengiyibeka	se ngi yi bek a
kawuguqukanga	ka wu guquk anga
ephambi	e phambi
zona	zo na
nhloboni	n hlobo ni
uqinisa	u qin is a
emakethe	e makethe
uthuthuva	u thuthuv a
kadambe	ka dambe
kufuneka	ku fun ek a
elihlola	e li hlol a
ebhekephi	e bhek e phi
wasukuma	w a sukum a
baphinde	ba phind e
ungakhali	u nga khal i
umakoti	u makoti
ngisho	ngi sho
ezimbili	e zim bili
udaliwe	u dal iw e
ekugcineni	e ku gcin eni
isifuba	i si fuba
wayesenovalo	w a ye se n o valo
kumazulu	ku ma zulu
athini	a thi ni
ubedlala	u be dlal a
esachitha	e sa chith a
ukuzifihla	u ku zi fihl a
ngathubeleza	ng a thubelez a
ukuhlanzeka	u ku hlanz ek a
senishayele	se ni shay el e
sinqakisane	si nqak is an e
sekukhala	se ku khal a
osekungene	o se ku ngen e
ukuqagela	u ku qagel a
anginazihlobo	a ngi na zi hlobo
ngamadolo	ng a ma dolo
lezizimpahla	le zi zim pahla
ithini	i thi ni
izoshonela	i zo shon el a
eyayikusho	e y a yi ku sho
ngidabukela	ngi dabuk el a
ukudakwa	u ku dak w a
ungaphla	u ngaphla
iphuzu	i phuzu
ungundwandwe	u ngundwandwe
naloya	na lo ya
babegqigqizela	b a be gqigqiz el a
uhluphile	u hluph ile, u hluphil e
intekentekana	i n tekentek ana
eke	e ke
uhlezi	u hlez i
impesheni	i m pesheni
mibili	mi bili
usefile	u se f ile
beyiphethe	be yi pheth e
liyagxuma	li ya gxum a
nyoka	nyoka
ezama	e zam a
uyisithandwa	u y i si thand w a
uze	u z e
kwakungekho	kw a ku nge kho
kokudingekile	k o ku ding ek ile
kwezami	kw e za mi
sengifile	se ngi f ile
awusho	a wu sho
useyoyivula	u se yo yi vul a
efana	e fan a
imbone	i m bon e
ephuza	e phuz a
wawulibonephi	w a wu li bon e phi
zithathe	zi thath e
ababengase	a ba be nga se
eziningi	e zi ningi
yanamuhla	ya namuhla
ngisalenza	ngi sa l enz a
izindawo	i zin dawo
sengiyasukuma	se ngi ya sukum a
wemuka	w emuk a
elabe	e labe
kangakanani	ka ngaka na ni
uchithimpi	u chith i m pi
yabalindi	y a ba lind i
siphila	si phil a
badleni	ba dl e ni
wagoba	w a gob a
akathandanga	a ka thand anga
ibe	i b e
wangabe	w angabe
sinengozi	si n e n gozi
qede	qede
kwashiwo	kw a sh iw o
ebheke	e bhek e
kuloluhambo	ku lo lu hamb o
enwaya	e nway a
wacabanga	w a cabang a
yayibangenile	y a yi ba ngen ile
aseqhubeka	a se qhub ek a
yizikhathi	y i zi khathi
kwelakithi	kw e la ki thi
bayafika	ba ya fik a
kunatana	ku natana
ukudliwa	u ku dl iw a
sifukamela	si fukam el a
beseyiziswambithi	be se y i zi swambithi
uzozikhunga	u zo zi khung a
ezenziwa	e z enz iw a
kabuhlungu	ka buhlungu
sibamba	si bamb a
abadukisa	a b a duk is a, a ba duk is a
iyokwethulwa	i yo kw ethul w a
waciba	w a cib a
usebenza	u sebenz a
enanikhuluma	e n a ni khulum a
emithathu	e mi thathu
angasho	a nga sho
wokuhamba	w o ku hamb a
usesebaleni	u se se bal eni
olufundiswayo	o lu fund is w a yo
yangqofa	y a ngqof a
ayenzayo	a y enz a yo
ngebhokisi	ng e bhokisi
ngingasafuni	ngi nga sa fun i
bayatatazela	ba ya tataz el a
iziphukuphuku	i zi phuku phuku
nosizayo	n o siz a yo
wabonga	w a bong a
ehlezi	e hlez i
ehlushwa	e hlush w a
omhlophe	o mhlophe
nedelelekile	n e del el ek ile
abebezivakashele	a be be zi vakash el e
ukuphela	u ku phel a
niyoyikhipha	ni yo yi khiph a
yami	ya mi
efunwa	e fun w a
yathula	y a thul a
kayithandwa	ka yi thand w a
usethuthile	u se thuth ile
sengihleli	se ngi hlel i
mkhulu	m khulu
azifisayo	a zi fis a yo
zobusha	z o bu sha
ukugoba	u ku gob a
awebhubesi	a w e bhubesi
yawukhomba	y a wu khomb a
wona	w on a, wo na
sengicabangisisa	se ngi cabang isis a
uthengelwe	u theng el w e
ilaphaya	i laphaya
kwakuyigama	kw a ku y i gama
sengikade	se ngi kade
nalamadoda	na la ma doda
esimphethe	e si m pheth e
abonakale	a bon akal e
aphiphithe	a phiphith e
uyazibuza	u ya zi buz a
namabhantshi	n a ma bhantshi
umfundisi	u m fund is i
nasethaya	na se thaya
angabulawa	a nga bula w a
belobiza	be lobiz a
emthoba	e m thob a
yokuthi	y o kuthi
ngimazelaphi	ngi m az el a phi
nokuguqula	n o ku guqul a
lalisukela	l a li suk el a
ihlakaniphe	i hlakaniph e
uwalungisela	u wa lung is el a
kusolasoleke	ku sola sol ek e
ephapheme	e phaphem e
kayiyazi	ka yi y azi
nendoda	n e n doda
kawufani	ka wu fan i
ngokwethuka	ng o kw ethuk a
akhethe	a kheth e
wazinika	w a zi nik a
ukunqobile	u ku nqob ile
ngingadlula	ngi nga dlul a
ngangingezuphumelela	ng a ngi nge zu phumelel a
bayezwelana	ba y ezw el an a
zenze	z enz e
noyihlo	n o yihlo
isikhumba	i si khumba
bafanele	ba fanel e
usagcwele	u sa gcwel e
nesenyathi	n e s e nyathi
onomoya	o n o moya
ukulibona	u ku li bon a
kangisenamali	ka ngi se na mali
siza	si z a
size	si z e
angisafuni	a ngi sa fun i
ngendlela	ng e n dlela
ibangana	i bang an a
izibuko	i zi buk o
usuyayazi	u s u ya y azi
siyokubeka	si yo ku bek a
kusemqoka	ku se m qoka
namadikoni	na ma dikoni
ulamana	u lam an a
esithi	e si thi
uyibhekisisa	u yi bhek isis a
eseyedwa	e se ye dwa
saze	s a z e
nezindlovu	n e zin dlovu
lenkulumo	l e n kulum o, le n kulum o
insimbi	i n simbi
njengomuntu	njeng o mu ntu
eyongena	e yo ngen a
uyazi	u y azi
abalinde	a ba lind e
asebemphuzisile	a se be m phuz is ile
ephuthumisa	e phuthum is a
ngagudaza	ng a gudaz a
kokuthi	k o kuthi
bezeki	b e zeki
ukuphi	u ku phi
amagama	a ma gama
hlobo	hlobo
emakhaya	e ma khaya
kuyofezeka	ku yo fez ek a
siqonde	si qond e
loku	lo ku
ayenyathela	a ye nyathel a
loko	lo k o
kwabasengathi	kw a b a sengathi
kusangithatha	ku sa ngi thath a
esheshe	e shesh e
ecabanga	e cabang a
isilapha	isilapha
isheshe	i shesh e
kanyekanye	ka nye ka nye
ebusuku	e bu suku
bomkhwenyane	b o m khwenyane
mabangene	ma ba ngen e
iwasekhaya	i wa se khaya
ngizosho	ngi zo sho
akade	a kade
ukoma	u k om a
angase	a nga se
udinga	u ding a
sekuthathwa	se ku thath w a
lamazwi	l a ma zw i
sasihlala	s a si hlal a
alindele	a lind el e
ukuze	ukuze, u kuze
ongibulalayo	o ngi bu lal a yo
ukuza	u ku z a
okonakele	o k on akel e
abantababantu	a ba nta b a ba ntu
konje	konje
kumelwe	ku m el w e
sokuyinakekela	s o ku yi nak ek el a
uphakathwayo	u phakath w a yo
usuyakwazi	u s u ya kw azi
zathi	z a thi
wayikhomba	w a yi khomb a
lemali	le mali
sebuphelile	se bu phel ile
ukungalumi	u ku nga lum i
nomfanyana	n o m fany ana
nabakwansinyane	n a ba kwa nsinyane
akhale	a khal e
ibona	i bon a
kucishe	ku cishe
nalo	na lo
ziwudaka	ziwudaka
umgcinisikhwama	u mgcinisikhwama
yokugezela	y o ku gez el a
isibhala	i s i bhal a
bazi	b azi
yinto	y i n to
unenhlanhla	u n e n hlanhla
angayingeni	a nga yi ngen i
ungwenya	u ngwenya
ayalazi	a ya l azi
ezibukela	e zi bukel a
unayikosiyayi	u na y i kosi ya yi
azo	a zo
kwehle	kw ehl e
ecubungula	e cubungul a
kwehla	kw ehl a
nenyoni	n e nyoni
wathula	w a thul a
onyonyoba	o nyonyob a
ulale	u lal e
nasendleleni	na se n dlel eni
ungukuphela	ungukuphela
amakhasi	a ma khasi
elokhu	e lokhu
bembona	be m bon a
sagxumela	s a gxumel a
imibuzo	i mi buz o
ayaludinga	a ya lu ding a
ukuphupha	u ku phuph a
lakwamahleka	la kwa ma hleka
uyophilisa	u yo phil is a
ukuphambana	u ku phamban a
ngiwakhumbuza	ngi wa khumbuz a
akumsizi	a ku m siz i
luthathe	lu thath e
amathinzane	a ma thinz ane
esezitubela	e se zi tub el a
abaphansi	a ba phansi
usithumele	u si thum el e
wayelubalubeka	w a ye lubalub ek a
uqale	u qal e
wadlulisa	w a dlul is a
ngisethekwini	ngi se thekw ini
angamdleli	a nga m dl el i
ngokwami	ng o kwa mi
wamkhuthaza	w a m khuthaz a
engingumfelwa	e ngi ng u m f el w a
ilangabi	i langabi
baqonde	ba qond e
kudalwe	ku dal w e
baqonda	ba qond a
asefuna	a se fun a
ibuye	i buye
akubange	a ku bang e
ukubhaliswa	u ku bhalis w a
usungamahlamvu	u s u ng a ma hlamvu
ishibhi	i shibhi
ngonyaka	ng o nyaka
silima	si lima
tajewo	tajewo
amane	a mane
uxhwatha	u xhwath a
kuthiwa	ku th iw a
ongalala	o nga lal a
kuthiwe	ku th iw e
umthakathi	u m thakath i
ayekuphethe	a ye ku pheth e
inqawe	i n qawe
wagelekeqeka	w a gelekeq ek a
owayezongena	o w a ye zo ngen a
uyazama	u ya zam a
usesilungwini	u se si lungw ini
isendlini	i se n dl ini
wayilwa	w a yi lw a
singambona	si nga m bon a
ngodaka	ng o daka
namagwababa	n a ma gwababa
makube	ma ku b e
ushanti	u shanti
amazwe	a ma zwe
uqonda	u qond a
ezasegugwini	e za se gugw ini
kwenzeke	kw enz ek e
inja	i n ja
eyilalela	e yi lalel a
kwenzeka	kw enz ek a
amazwi	a ma zw i
agingqike	a gingqik e
babecabanga	b a be cabang a
seliyezwa	se li y ezw a
nezingane	n e zin gane
ngicele	ngi cel e
komuzi	k o mu zi
ngicela	ngi cel a
ehlola	e hlol a
izinkophe	i zin kophe
uqobo	u qobo
nimbeke	ni m bek e
wayetubeke	w a ye tub ek e
nobani	n o bani
bandla	bandla
kwayona	kwa yo na
walesula	w a l esul a
wanyenyeza	w a nyenyez a
phezulu	phezulu
ukuzipheka	u ku zi phek a
selimlandele	se li m landel e
kwabacacela	kw a ba cac el a
sekuyalungiswa	se ku ya lung is w a
baphephile	ba pheph ile
akamnaka	a ka m nak a
ngisafanisa	ngi sa fan is a
ongenalo	o nge na lo
okhalayo	o khal a yo
amangale	a mangal e
ngaphupha	ng a phuph a
ukwenzenjani	u kw enz e njani
isitembu	i si tembu
sengizimisele	se ngi zi m is el e
ebonga	e bong a
iyesaba	i yesab a, i y esab a
nababoshiwe	n a ba bosh iw e
yamkhipha	y a m khiph a
kanomhlanjana	ka n o m hlanj ana
umbala	u m bala
yeyembe	y e yembe
ngesomuntu	ng e s o mu ntu
bayazisebenzela	ba ya zi sebenz el a
bayokuhlasela	ba yo ku hlas el a
eseyicula	e se yi cul a
kubazali	ku ba zal i
ama	a m a
ngqo	ngqo
wayelokbu	wayelokbu
ame	a m e
lisafuna	li sa fun a
ngqi	ngqi
ayesafisa	a ye sa fis a
ufezela	u fezela
umanhlengethwa	u manhlengethwa
ababebandlululwa	a ba be bandlulul w a
bathathwe	ba thath w e
kule	ku le
usoniwe	u s on iw e
ngamaphuphu	ng a ma phuphu
bengingayazi	be ngi nga y azi
kulo	ku lo
ihamba	i hamb a
phuhle	phuhle
abayazi	a ba y azi
kubuye	ku bu y e, ku buy e
isadukelwe	i sa dukel w e
beliqeda	be li qed a
waphoseka	w a phos ek a
ngafelwa	ng a f el w a
zaziphela	z a zi phel a
ebambe	e bamb e
ifa	i f a
babebuza	ba be buz a
kugula	ku gul a
basuse	ba sus e
habe	habe
untombazana	u ntombazana
ukumenza	u ku m enz a
edlulela	e dlulel a
zokulima	z o ku lima
ukubonwa	u ku bon w a
zikatebha	z i katebha
usezwile	u se zw ile
ngicabanga	ngi cabang a
ayebazi	a ye b azi
eyayimqeda	e y a yi m qed a
ngiyombulala	ngi yo m bulal a
bayikhombise	ba yi khomb is e
lamakhehla	l a ma khehla
eziphuzile	e zi phuz ile
okubalulekile	o ku balul ek ile
ngokukhala	ngo ku khal a
kubonga	ku bong a
wangicika	w a ngi cik a
asiyiyeke	a si yi yek e
ngenhlanhla	ng e n hlanhla
ukungenzela	u ku ng enz el a
ozosho	o zo sho
wazithi	w a zi thi
sincokola	si ncokol a
uyindoda	u yindoda
ahlupheke	a hluph ek e
iphi	i phi
nomahazula	n o ma hazula
waze	w a ze
sebehamba	se be hamb a
kithi	ki thi
ongamchazela	o nga m chaz el a
wazi	w azi
kwezindololwane	kw e zin dololwane
abahlonipha	a ba hloniph a
benziwa	b enz iw a
ngiyambuka	ngi ya m buk a
kuzodingeka	ku zo ding ek a
ozolisho	o zo li sho
muhle	mu hle
benyuka	b enyuk a
ibhungane	i bhungane
kanatana	ka natana
yinhle	yi n hle
kabazani	ka ba zani
kusembawuleni	ku se m bawul eni
aphanga	a phang a
liyongena	li yo ngen a
nilale	ni lal e
ishayile	i shay ile
ngingumfundisi	ngi ng u m fund is i
waqonda	w a qond a
esevumile	e se vum ile
isiguqo	i si guq o
kwamntungwa	kwa mn tungwa
bahlenga	ba hleng a
eyabe	e y a be
womfowethu	w o m fowethu
ozithobayo	o zi thob a yo
nokuzimisela	n o ku zi m is el a
amandwandwe	a ma ndwandwe
silapha	si lapha
awuzozwa	a wu zo zw a
yalaba	ya la ba
insumansumane	i n sumansumane
ngisengxakini	ngi se ngxak ini
ikhehla	i khehla
sezimhleka	se zi m hlek a
sengicabanga	se ngi cabang a
engahle	e nga hle
okubulala	o ku bulal a
abaziphatha	a ba zi phath a
kuyadlala	ku ya dlal a
ebesemncane	e be se m ncane
sasho	s a sho
kubhoke	ku bhok e
eyitshela	e yi tshel a
kwalokhu	kwa lo khu
wabo	wa bo
akuzuyiwa	a ku zu y iw a
mayiphume	ma yi phum e
usabhuquza	u sa bhuquz a
ngizibike	ngi zi bik e
kwalokho	kwa lo kh o
nomcabango	n o m cabang o
akazi	a k azi
okwangiqeda	o kw a ngi qed a
ubheke	u bhek e
ungaphumeleli	u nga phumelel i
ubheka	u bhek a
ungikhululela	u ngi khulul el a
yesintu	y e si ntu
banginike	ba ngi nik e
otajewo	o tajewo
angifundise	a ngi fund is e
kukamshini	kuka m shini
ethethisana	e theth is an a
khehla	khehla
kesiye	ke si y e
ezobakhweza	e zo ba khwez a
yindawo	y i n dawo
wayibikela	w a yi bikel a
unelungelo	u n e lungel o
kwakuzomnika	kw a ku zo m nik a
nani	na ni
omdala	o m dala
engangize	e ng a ngi z e
idlalwa	i dlal w a
kwakunguchithimpi	kw a ku ng u chith i m pi
ngifa	ngi f a
esikhwameni	e si khwam eni
labo	la bo, la b o
kimi	ki mi
babeqonda	ba be qond a
abathunywe	a ba thuny w e
lomgcagco	l o m gcagc o
igceke	i gcek e
cabanga	cabang a
bahlehlela	ba hlehl el a
eyayifikile	e ya yi fik ile, e y a yi fik ile, e y a yi fikil e
namuntu	n a mu ntu
nikhumbule	ni khumbul e
wendlu	w e ndlu
akukwakho	a ku kwa kho
isimilamongo	i si mila mongo
obhalayo	o bhal a yo
bengithi	be ngi thi
owesifazane	o w e si faz ane
okudingekayo	o ku ding ek a yo
yimisebenzi	y i m isebenzi
sikwazi	si kw azi
kwalemali	kwa le mali
khulula	khulul a
uyalilahla	u ya li lahl a
bekuzobathatha	be ku zo ba thath a
okwezandla	o kw e z andla
yizifo	y i zi fo
ungitheni	u ngi th e ni
balapha	balapha
buthi	bu thi
ukuwuphendula	u ku wu phendul a
sengihamba	se ngi hamb a
azobuye	a zo buy e
ezibuko	e zi buk o
unyoko	u nyoko
bomakhelwane	bo makhelwane
abaziphethe	a ba zi pheth e
muzi	mu zi
ashayeke	a shay ek e
nina	ni na
sikhulekile	si khul ek ile
nesithumuthumu	n e si thumuthumu
nini	nini
basabonga	ba sa bong a
ngathi	ng a thi
izokulimaza	i zo ku limaz a
ifika	i fik a
babelungu	b a be lungu
bengiye	be ngi ye
elakhe	e la khe
hha	hha
hhe	hhe
eshona	e shon a
hho	hho
yalapha	y alapha
yimina	yi mi na
sengakhetha	se ng a kheth a
babekhulumela	b a be khulum el a
kumpontshi	ku mpontshi
athande	a thand e
baziphathe	ba zi phath e
ibheshu	i bheshu
usazoncengeka	u sa zo nceng ek a
ihlombe	i hlombe
ngonyama	ng o nyama
unqaba	u nqab a
wakuthatha	w a ku thath a
kandwandwe	ka ndwandwe
abefundisi	a be fund is i
kuvele	ku vele
uphinda	u phind a
azihluphe	a zi hluph e
awuzwa	a wu zw a
abilayo	a bil a yo
bekunganjani	be ku nga njani
basacabanga	ba sa cabang a
kudllwa	ku dll w a
kababobuya	ka ba bo buy a
kubuzwa	ku buz w a
ngejaz	ng e jaz
kuningi	ku ningi
awukulahlile	a wu ku lahl ile
ngikunikelani	ngi ku nik el a ni
kusedobs	ku se dobs
emaphusheni	e ma phush eni
amaqembu	a ma qembu
empeleni	e m pel eni
akuphelanga	a ku phel anga
ngangingakaze	ng a ngi nga ka ze
wuluwulu	wuluwulu
lalela	lalel a
kuhamba	ku hamb a
kuhambe	ku hamb e
umcabango	u m cabang o
ngeshwa	ng e shwa
kwakufakazelwa	kw a ku fakazel w a
ubulima	u bu lima
kwezwakala	kw ezw akal a
ntaba	n taba
emaceleni	e ma cel eni
akufunde	a ku fund e
wafica	w a fic a
zalutho	za lu tho
umnu	u m nu
kuchithimpi	ku chith i m pi
ifu	i fu
nezigi	n e zi gi
ebika	e bik a
bahamba	ba hamb a, b a hamb a
bahambe	ba hamb e
ayihlali	a yi hlal i
nesonto	n e sonto
kuxutshwe	ku xutsh w e
nombuso	n o m bus o
umthwalo	u m thwal o
ngizophekelwa	ngi zo phekel w a
nasempilweni	na se m pil w eni
isilima	i si lima
yithi	yi thi
zakubona	z a ku bon a
ezidlulayo	e zi dlul a yo
enginalo	e ngi na lo
kakukho	ka ku kho
ubulolongekile	u b u lolong ek ile
seyithande	se yi thand e
kubenyezele	ku benyezel e
yokuthuthukiswa	y o ku thuthuk is w a
ngingasho	ngi nga sho
igcinile	i gcin ile
ugugile	u gug ile
esingalali	e si nga lal i
mahazula	ma hazula
sisakuhlehlisela	si sa ku hlehl is el a
nathengisa	n a theng is a
laba	la ba
labe	l ab e
ekhuphukayo	e khuphuk a yo
yabakwabuthelezi	y a ba kwa buthelezi
isidingo	i si ding o
kaliluphile	ka li lu ph ile
esekhanyise	e se khany is e
base	ba se
limele	li m el e
ase	a s e
basa	b a s a
benkunzi	b e n kunzi
ngisayixoxela	ngi sa yi xox el a
ligcotshiwe	li gcotsh iw e
esamkhuza	e sa m khuz a
sehlulekile	s e hlul ek ile
lamathuna	l a ma thuna, la ma thuna
ebhaliwe	e bhal iw e
yindaba	y i n daba
knott	knott
besuka	be suk a
iyayidinga	i ya yi ding a
sisondela	si sondel a
abazokukhombisa	a ba zo ku khomb is a
sakufica	s a ku fica, s a ku fic a
ukuhhuma	u ku hhum a
uzenza	u z enz a
uzenze	u z enz e
angakaya	a nga ka y a
wabona	w a bon a
umzinyathi	u m zi nyathi
nakumnaka	na ku m nak a
awazi	a w azi
kwakuyibona	kw a ku yi bon a
ayiphendule	a yi phendul e
uzofela	u zo f el a
niyazi	ni y azi
uzoyibiza	u zo yi biz a
eyobathatha	e yo ba thath a
lendlela	l e n dlela
bayizithunjwa	ba y i zi thunj w a
kwaqala	kw a qal a
kusentendeni	ku se n tend eni
walungisa	w a lung is a
abagwaza	a ba gwaz a
ithululwa	i thulul w a
makahambe	ma ka hamb e
usale	u sal e
umusa	u mu sa
ezifana	e zi fan a
uziphekele	u zi phek el e
zethu	z ethu
isiyaziwa	i s i y az iw a
ziyayikhahlela	zi ya yi khahl el a
onjengami	o njenga mi
bazongena	ba zo ngen a
isingamjikijela	i s i nga m jikij el a
angisayithandi	a ngi sa yi thand i
ngendlala	ng e n dlala
amnike	a m nik e
amaloli	a ma loli
kwazo	kwa zo
kwazi	kw azi
kwaze	kw a ze, kw a z e
engaka	e ngaka
kababaningi	ka b a ba ningi
ukusho	u ku sho
kuleyondawo	ku le y o n dawo
isimane	i s i mane
uthuke	u thuk e
aguqe	a guq e
wakudlisa	w a ku dl is a
alandilandiswe	a landiland is w e
obunzima	o bu nzima
wokuphuma	w o ku phum a
nezikhokho	n e zi khokho
engenaluzwelo	e nge na lu zw el o
amashumi	a ma shumi
beshabasheka	be shabash ek a
awezwe	a w ez w e, a w ezw e
balindele	ba lind el e
kawunoni	ka wu non i
balindela	ba lind el a
ukuhlanza	u ku hlanz a
wokwetshelekana	w o kw etshel ek an a
alisabashiseli	a li sa ba sh is el i
ngasekupheleni	nga se ku phel eni
wanikina	w a nikin a
okomcibisholo	o k o m cibisholo
usetshenziselwa	u setshenz is el w a
ezitebhisini	e zi tebhis ini
wahlangana	w a hlangan a
wayengayimosi	w a ye nga yi mos i
esinqabile	e si nqab ile
mbhense	m bhens e
ekulesisimo	e ku le si si m o
sobabili	so ba bili
sekunje	se ku nje
kungakhohlakaleki	ku nga khohl akal ek i
kwasho	kw a sho
muntu	mu ntu
wayekhangwa	w a ye khang w a
izinkuni	i zin kuni
elincane	e li ncane
sesichaza	se si chaz a
x	x
kwamanela	kw a m anel a
osebamele	o se ba m el e
namaxhegu	n a ma xhegu
ayishoyo	a yi sho yo
uziphume	u zi phum e
laliwukhesiya	l a li wu khesiy a
olisekela	o li sek el a
nkosikazi	n kosi kazi
bukhombisa	bu khomb is a
engakhulumanga	e nga khulum anga
leso	le s o
sekugcotshwa	se ku gcotsh w a
umamncube	u ma m ncube
ababenomkhuba	a b a be n o m khuba
kutshelwe	ku tshel w e
isibhunywana	i si bhunyw ana
efasiteleni	e fasitel eni
ukuvevezela	u ku vevezel a
buthutha	bu thuth a
ngumuphi	ngu mu phi
izimvume	i zim vume
ephelayo	e phel a yo
kwemizi	kw e mi zi
yelambu	y e lambu
ethengisa	e theng is a
wenyoni	w e nyoni
yenzekile	y enz ek ile
ebekelwe	e bek el w e
kubuhlungu	ku buhlungu
ezinkulu	e zin kulu
ehamba	e hamb a
bafunani	ba fun a ni
esefike	e se fik e
ungikhalela	u ngi khal el a
isesidlekeni	i se si dlek eni
kwethunzi	kw e thunzi
yokuqala	y o ku qal a
wayesewulahlile	w a ye se wu lahl ile
elunge	e lung e
owenzenjena	o w enz e nje na
damu	damu
bazothi	ba zo thi
khumbula	khumbul a
ziyaphila	zi ya phil a
ilanga	i langa
yimbi	yi m bi
zikhula	zi khul a
isonto	i sonto
iye	i y e
ngumbuso	ng u m bus o
yayozihlalela	y a yo zi hlal el a
iya	i y a
leyo	le y o
ibabuze	i ba buz e
leya	le ya
wafumanisa	w a fuman is a
selimathambama	se li mathambama
ushayekile	u shay ek ile
kulentaba	ku le n taba
izikole	i zi kole
beze	be ze, be z e
nelanga	n e langa
beza	be z a
babuze	ba buz e
yomkhi	y o m kh i
wayengafunga	w a ye nga fung a
kumele	ku m el e
uphumule	u phumul e
ebhange	e bhange
lihlala	li hlal a
amasi	a ma si
ukuthuthwa	u ku thuth w a
luzovuthwa	lu zo vuth w a
kokhotheme	k o khothem e
bamangale	ba mangal e
ngakusasa	nga kusasa
yehlula	y ehlul a
neqholwayo	n e qhol w a yo
azifani	a zi fan i
samthatha	s a m thath a
athule	a thul e
wamfunani	w a m fun a ni
lalifakelwa	l a li fak el w a
iyangixaka	i ya ngi xak a
ebhokisini	e bhokis ini
asikufuni	a si ku fun i
ucabanga	u cabang a
yayibhekene	y a yi bhek en e
iphethe	i pheth e
wozwakala	w o zw akal a
wayeke	w a ye ke
ngisanqikaza	ngi sa nqikaz a
kambe	kambe
ngimthathaphi	ngi m thath a phi
ngibhala	ngi bhal a
ezicijile	e zi cij ile
lomakoti	lo makoti
ngamcela	ng a m cel a
okumele	o ku m el e
likhanya	li khany a
yinsini	y i n sini
makabuyele	ma ka buy el e
babehamba	ba be hamb a
izambane	i z ambane
imbuzi	i m buzi
phakade	phakade
omude	o mu de
zakhokhiswa	z a khokh is w a
akususe	a ku sus e
asebenzile	a sebenz ile
ngiyaxolisa	ngi ya xol is a
ujosaka	u josaka
kusho	ku sho
endaweni	e n daw eni
awukafuni	a wu ka fun i
gama	gama
esinjani	e si njani
ulethe	u leth e
eyikhumbula	e yi khumbul a
wazimisela	w a zi m is el a
intuthu	i n tuthu
wamxoxela	w a m xox el a
bebobabili	be bo ba bili
owayeyoba	o w a ye yo b a
nalendoda	na le n doda
ngiyomxoxela	ngi yo m xox el a
lingani	li ngani
kuleliyalizwe	ku le li ya li zwe
asefinyele	a se finyel e
nobukholwa	n o bu khol w a
makabonge	ma ka bong e
bakwa	ba kwa
lathi	l a thi
esexolisa	e se xol is a
waxoxela	w a xoxel a
ayibulale	a yi bulal e
usungumpetha	usungumpetha
esihlahleni	e si hlahl eni
ubuthaphuthaphu	u bu thaphuthaphu
engamashumi	e ng a ma shumi
ezincoma	e zi ncom a
kwenzenjani	kw enz e njani
bahleka	ba hlek a
akasenamandla	a ka se na ma ndla
ezinqola	e zin qola
sebelele	se be lel e
lisaqonde	li sa qond e
wayesekushaya	w a ye se ku shay a
wacosha	w a cosh a
zithwele	zi thwel e
wakwamowabi	wa kwa mowabi
zombhede	z o m bhede
lomhlangano	l o m hlangan o
yiru	yi ru
wangala	w a ng al a
nojakobe	n o jakobe
aya	a y a
ngingumbhuqwa	ngi ng u m bhuq w a
olicabangayo	o li cabang a yo
wayengithanda	w a ye ngi thand a
isigcino	i si gcin o
evela	e vel a
ayengaze	a ye nga ze
amakholwa	a ma khol w a
olwamahhala	o lwa ma hhala
balotsholwa	ba lotshol w a
amangalisa	a mangal is a
sebethole	se be thol e
kungekho	ku ng ekho
abese	a be se
kwathiwa	kw a th iw a
phansi	phansi
neyensikazi	n e y e n sikazi
esezazi	e se z azi
nokusetshenziswa	n o ku setshenz is w a
amagogolo	a ma gogolo
izovela	i zo vel a
kankazana	ka nkaz ana
ufake	u fak e
abheke	a bhek e
engaboni	e nga bon i
onjengomhlongo	o njeng o m hlongo
bamxosha	ba m xosh a, b a m xosh a
namayembe	n a ma yembe
yabafana	y a ba fana
ukukhipha	u ku khiph a
emtshela	e m tshel a
yezincwadi	y e zi ncwadi
imphatha	i m phath a
bamhlinze	ba m hlinz e
nizowaqhamukela	ni zo wa qhamuk el a
ukuzikhunga	u ku zi khung a
yomuzi	y o mu zi
lizokuba	li zo ku b a
angenzanga	a ng enz anga
kashakespeare	ka shakespeare
uyayiphika	u ya yi phik a
ivale	i val e
niyangiqambela	ni ya ngi qamb el a
emkhathini	e m khath ini
ngamaphoyisa	ng a ma phoyisa
uzomdlisa	u zo m dl is a
lokuba	l o kuba
beshiya	be shiy a
owazumeka	o w a zum ek a
ukhuluse	u khulus e
eyibiza	e yi biz a
akabezwa	a ka bez w a
namasondo	na ma sondo
asakulindile	a sa ku lind ile
kamnandi	ka mnandi
kuseyilo	ku se yi lo
ngibheka	ngi bhek a
ehhokweni	e hhokw eni
oluxoxekayo	o lu xox ek a yo
nempilo	n e m pil o
betshelwa	be tshel w a
e	e
singeze	si ngez e
kuniphathe	ku ni phath e
ushaka	u shaka
liyakwazi	li ya kw azi
akukho	a ku kho
emendweni	e m end w eni
masishane	ma si sh an e
nobufakazana	n o bu fakaz ana
nemibokwane	n e mi bokw ane
awunyakazisa	a wu nyakaz is a
ngesihenqo	ng e si henq o
beqala	be qal a
wayebona	w a ye bon a
wezizwe	w e zi zwe
esezibika	e se zi bik a
washo	w a sho
ngihlangene	ngi hlangen e
saphinda	s a phind a
ezithombeni	e zi thomb eni
asecuphe	a se cuph e
izitha	i zi tha
namadodana	n a ma dod ana
ngokuhlonipha	ng o ku hloniph a
cwaka	cwaka
ayivulele	a yi vul el e
kwadlamini	kwa dlamini
engihluphayo	e ngi hluph a yo
esinye	e si nye
ngizothi	ngi zo thi
akusizi	a ku siz i
ukulesisimo	u ku le si si m o
kukhokhwa	ku khokh w a
noshintshi	n o shintshi
beshaya	be shay a
nokuphendula	n o ku phendul a
ezingcwele	e zi ngcwel e
ngedlula	ng edlul a
likanokusho	lika n o ku sho
ngenhlanhlake	ng e n hlanhla ke
kuzindendandenda	ku zi ndenda ndend a
esikhotheni	e si khoth eni
ohlala	o hlal a
kwasilatini	kwa si latini
eyangihluphayo	e ya ngi hluph a yo
bekhwezwe	be khwez w e
ngucome	ng u come
afake	a fak e
bafuthi	ba futhi
ze	ze
okumvelelayo	o ku m vel el a yo
uthibile	u thib ile
ekusebenziseni	e ku sebenz is eni
walokhu	wa lo khu
ngalezizitebhisi	nga le zi zi tebhisi
ngokuzibulala	ng o ku zi bulal a
abekezela	a bekezel a
nalombuzo	na lo m buz o
bezindawo	b e zin dawo
zinamathelene	zi n a ma thelene
angibizanga	a ngi biz anga
obukhulu	o bu khulu
cela	cel a
ukuhlolwa	u ku hlol w a
oze	o z e
siyombona	si yo m bon a
oza	o z a
ungakatholi	u nga ka thol i
othanda	o thand a
ngendodana	ng e n dod ana
ngcono	ngcono
uphuza	u phuz a
imbuyisela	i m buy is el a
ongabe	o nga be
babenezikhowe	ba be n e zi khowe
ayezwa	a y ezw a
ezinsizweni	e zi nsizw eni
washona	w a shon a
owakhuluma	o w a khulum a
asigudluze	a si gudluz e
lamanqe	l a ma nqe
ugcina	u gcin a
yaphuma	y a phum a
umeromo	u meromo
egqoke	e gqok e
ensimaneni	e n siman eni
bashaye	ba shay e
osenzela	o s enz el a
wakha	w akh a
wakhe	wa khe
wakho	wa kho
evamisile	e vamis ile
kuyabonakala	ku ya bon akal a
intando	i n tand o
awayeke	a wa yek e
kuyahanjwa	ku ya hanj w a
sibonge	si bong e
aqale	a qal e
imikhono	i mi khono
aqala	a qal a
olidla	o li dl a
abempofu	a be mpofu
bayizwile	ba yi zw ile
enayo	e na yo
nokwesaba	n o kw esab a
ngingasezwa	ngi nga se zw a
wayengumntanekhaladi	w a ye ng u m ntan e khaladi
sinamalahle	si n a ma lahle
okwengulube	o kw e n gulube
ibhuku	i bhuku
engithanda	e ngi thand a
uzophumelela	u zo phumelel a
eside	e si de
ezindadlana	e zin dadl ana
engujesu	e ng u jesu
kungebalwe	ku nge bal w e
eziyizinhlobonhlobo	e zi yizinhlobonhlobo
ngiyaphupha	ngi ya phuph a
egijima	e gijim a
wayocelela	w a yo cel el a
ingekho	i ng ekho
sanikhethela	s a ni kheth el a
ayenzile	a y enz ile
edanawozi	e danawozi
sizongena	si zo ngen a
wakusa	w a ku s a
kudingeke	ku ding ek e
akake	a ka ke
wezinkomo	w e zin komo
ihlaya	i hlaya
oshayo	o sh a yo
ngiyajabula	ngi ya jabul a
baphumule	ba phumul e
usithole	u si thol e
siqhunsule	si qhunsul e
wayengacebeki	w a ye nga ceb ek i
uyawazi	u ya w azi
okwakubuye	o kw a ku buy e
ebinawo	e b i na wo
wayezoqala	w aye zo qal a
bayagqibana	ba ya gqib an a
emobeni	e mob eni
qathatha	qathatha
yayikhala	y a yi khal a
ongangoyise	o ngang o yise
okunika	o ku nik a
wayesanxephezisa	w a ye sa nxephez is a
ngokuphazima	ng o ku phazim a
sasingakangiboni	s a si nga ka ngi bon i
iboshwa	i bosh w a
nomeromo	n o meromo
inzalo	i n zal o
esethandazelwe	e se thandaz el w e
isimdunge	i s i m dung e
ababengadeli	a ba be nga del i
untuli	u ntuli
bafunde	ba fund e
elotshwe	e lotsh w e
wangena	w a ngen a
ngishaywa	ngi shay w a
ubungangena	u b u nga ngen a
ngalokho	nga lo kh o
imfuyo	i m fuy o
nibe	ni b e
asivakashayo	a si vakash a yo
emnyama	e mnyama
ngifele	ngi f el e
likathisha	lika thisha
nezalukazi	n e z alu kazi
waqhuba	w a qhub a
engashoni	e nga shon i
igundane	i gundane
mamkhize	ma m khize
uzobona	u zo bon a
ngokuqhubeka	ng o ku qhub ek a
lomgexo	lo m gex o
ngalento	nga le n to
ngangihlabe	ng a ngi hlab e
uyinkosikazi	u y i n kosi kazi
ekhulumayo	e khulum a yo
abakwamidiyani	a ba kwa midiyani
lamagondoviya	l a ma gondoviya
ungayibona	u nga yi bon a
akaphume	a ka phum e
ngothi	ng o thi
usulu	u sulu
wawuhlawula	w a wu hlawul a
nguwena	ngu we na
fumuka	fumuka
akezwa	a k ezw a
ubizwa	u biz w a
esigabeni	e si gab eni
uzochotshiswa	u zo chotsh is w a
ngizophoqeka	ngi zo phoq ek a
nokumhluphayo	n o ku m hluph a yo
wakhona	wa kho na
umlandela	u m landel a
kungaqikelela	ku nga qikel el a
kwesihlahla	kw e si hlahla
yakwangono	ya kwa ngono
lutho	lu tho
wamvuma	w a m vum a
nokuhlonishwa	n o ku hlonish w a
kuyimfihlo	ku y i m fihl o
waphunyula	w a phunyul a
umhlophe	u m hlophe
kumbokodwe	ku m bokodwe
ngezinyawo	ng e zi nyawo
hamba	hamb a
bathuthana	b a thuth an a
kusile	ku s ile
kumanje	ku manje
ngiyamkhulumisa	ngi ya m khulum is a
ngingakayi	ngi nga ka y i
angiseyona	a ngi se yo na
aphinde	a phind e
ujulile	u jul ile
ayibalulekile	a yi balulek ile
yakwazi	y a kw azi
zadla	z a dl a
yona	yo na
zizongiphendula	zi zo ngi phendul a
engaphila	e nga phil a
eseqonde	e se qond e
bakhiphe	ba khiph e
umbokodwe	u m bokodwe
kulelizwe	ku le li zwe
bavele	ba vele
ayesethe	a ye se th e
thandindawo	thand i n dawo
lendaxavu	l e n daxavu
namanye	n a ma nye
basendleleni	ba se n dlel eni
beyebula	be y ebul a
nohlobi	n o hlob i
mvuthu	m vuthu
imali	i mali
bayakuthakatha	ba ya ku thakath a
wazibiza	w a zi biz a
angikwazi	a ngi kw azi
ngizobabeka	ngi zo ba bek a
sekubuthene	se ku buth en e
zingane	zin gane
ajabule	a jabul e
khusasa	khusas a
lowomuthi	lo w o mu thi
nakubuthwa	na ku buth w a
ekuzona	e ku z on a
neyisikhombisa	n e y i si khomb is a
chaphasha	chaphasha
usezame	u se zam e
owatshela	o wa tshel a
ngapho	ngapho
ukuthathwa	u ku thath w a
salalela	s a lalel a
ngapha	ngapha
zosayitsheni	z o sayitsheni
ngaxakeka	ng a xak ek a
amazambane	a ma zambane
wayelokhu	wayelokhu
ewadini	e wad ini
ukwakha	u kw akh a
useyajuluka	u se ya juluk a
uyothula	u yo thul a
singamnuka	si nga m nuk a
ayenokubonisana	a ye n o ku bon is an a
awu	awu
kwaphambana	kw a phamb an a
awo	a wo
ngambongela	ng a m bong el a
uyoyinquma	u yo yi nqum a
kusobala	ku so bala
kazihlapuni	ka zihlapuni
nosakhile	n o s akh ile
wemfengwane	w e m fengwane
ngawakha	ng a w akh a
ididekile	i did ek ile
kapteni	kapteni
nguwe	ngu we
zasuka	z a suk a
nonina	n o nina
ithungathana	i thungath an a
ingasaphili	i nga sa phil i
inunu	i nunu
nga	nga
udidi	u didi
ngo	ng o
ngu	ng u
asiphindele	a si phind el e
kunina	ku nina
exoxa	e xox a
sengiyolala	se ngi yo lal a
nginomusa	ngi n o mu sa
ungumuntu	u ng u mu ntu
benosikhuni	be n o si khuni
nabefundisi	n a be fund is i
ekhonga	e khong a
nezinkomo	n e zin komo
izolo	i zolo
siyoyimba	si yo yi mb a
eyiqeda	e yi qed a
eyayihlala	e y a yi hlal a
ngifike	ngi fik e
isishwaphuluza	i si shwaphuluz a
ephika	e phik a
owangixosha	o w a ngi xosh a
abathi	a ba thi
uyiveza	u yi vez a
abathe	a ba th e
simuse	si mu s e
dadewethu	dade w ethu
uwuhenqele	u wu henq el e
yimithi	y i mi thi
engaziwa	e ng az iw a
kwetafula	kw e tafula
siyabhalelana	si ya bhal el an a
isingekho	i s i nge kho
elambeka	e l a m bek a
ayisekho	a yi se kho
sibongile	si bong ile
izothuthwa	i zo thuth w a
ubengalishaya	u be nga li shay a
uhluphi	u hluphi
kukanye	ku ka nye
wacabangela	w a cabangel a
emphakathini	e m phakath ini
bayenyuka	ba y enyuk a
ngezitoxoyi	ng e zi toxoyi
angincenge	a ngi nceng e
ayibale	a yi bal e
uyakuzwa	u ya ku zw a
ofakwa	o fak w a
ngoshaka	ng o shaka
eyehlayo	e y ehl a yo
lishayele	li shay el e
awukwazi	a wu kw azi
sasinokugula	s a si n o ku gul a
kunokulahlekelwa	kun o ku lahl ek el w a
uyamphuzisa	u ya m phuz is a
amakhala	a ma khala
elaphakathi	elaphakathi
nokuzenamisa	n o ku z enam is a
besebenza	be sebenz a
ebastion	e bastion
okusayo	o ku s a yo
lowomsebenzi	lo w o m sebenz i
ukuzuza	u ku zuz a
azifune	a zi fun e
kubhulose	ku bhulose
lingibuka	li ngi buk a
esecabange	e se cabang e
wayomshiya	w a yo m shiy a
bancenge	ba nceng e
efika	e fik a
kwakuke	kw a ku ke
kwangenza	kw a ng enz a
yabantu	y a ba ntu
umkhi	u m khi
ucela	u cel a
intsha	i n tsha
ini	i ni
owakhiwe	o w akh iw e
iqembu	i qembu
angesabi	a ng esab i
wawungafika	w a wu nga fik a
behluleka	b ehlul ek a
zathathwa	z a thath w a
uzothengisa	u zo theng is a
amanesi	a ma nesi
namuhla	na mu hla
ngemfe	ng e m fe
imhlolela	i m hlol el a
xulu	xulu
angasuke	a nga suk e
umlilo	u m lilo
usazohamba	u sa zo hamb a
angasuka	a nga suk a
nansi	nan si
ziphathwe	zi phath w e
ingathi	i nga thi
alushi	a lu sh i
izinja	i zin ja
ukuphumula	u ku phumul a
enhliziyweni	e n hliziyw eni
ehlupheka	e hluph ek a
azabe	a z ab e
itshe	i tshe
bayashada	ba ya shad a
senze	s enz e
yomlilo	y o m lilo
ichaza	i chaz a
engingakusiza	e ngi nga ku siz a
exoxwayo	e xox w a yo
kutholakale	ku thol akal e
manzi	ma nzi
ukuwabona	u ku wa bon a
nomlomo	n o m lomo
usigodo	u si godo
akahlale	a ka hlal e
negoqwana	n e goqw ana
njena	nje na
kwakuyindlwana	kw a ku y i n dlw ana
iziphicaphicwano	i zi phica phic w an o
lingakafiki	li nga ka fik i
abavakashelayo	a ba vakash el a yo
lethiwe	l eth iw e
yacishe	y acishe
ximba	ximb a
uzokwemuka	u zo kw emuk a
yigosa	y i gosa
bathanda	ba thand a
bathande	ba thand e
abahlinzayo	a ba hlinz a yo
singili	singili
wedwa	we dwa
azidudoze	a zi dudoz e
kuyezwakala	ku y ezw akal a
ngakho	nga kho
emvondlweni	e m vondlw eni
eminyakeni	e mi nyak eni
ngesizulu	ng e si zulu
ngakha	ng akh a
yagcwala	y a gcwal a
bagqekezi	ba gqekez i
wanakana	w a nak an a
isigaba	i si gaba
kwasifuba	kwa si fuba
besingashiswa	be si nga sh is w a
ngophondo	ng o phondo
kwayekwa	kw a yek w a
obuhamba	o bu hamb a
ekuphethe	e ku pheth e
kumamncube	ku ma m ncube
esayaluza	e sa yaluz a
icebo	i ceb o
eshaywa	e shay w a
eshaywe	e shay w e
kanukani	ka nukan i
isithupha	i si thupha
ezakhe	e z akh e, e z akhe
emakhulwini	e ma khulw ini
komakati	k o makati
afike	a fik e
afika	a fik a
asheri	asheri
ngiyisiboshwa	ngi y i si bosh w a
awusalindi	a wu sa lind i
singangena	si nga ngen a
zikhuluma	zi khulum a
ephilile	e phil ile
abukeke	a buk ek e
ungazange	u nga zange
kusame	ku sa m e
sasinenhlanganisela	s a si n e n hlangan is el a
afune	a fun e
afuna	a fun a
afrika	afrika
beshiswa	be sh is w a
ngehashi	ng e hashi
aselindele	a se lind el e
phinde	phinde
oyilepu	o y i lepu
bakubona	ba ku bon a
ngobuhlakani	ng o bu hlakani
ho	ho
ngibe	ngi b e
he	he
ngingekuthande	ngi nge ku thand e
akasemubi	a ka se mu bi
bepha	be ph a
engingakulanda	e ngi nga ku land a
uphethwe	u pheth w e
yilababafanyana	yi la ba ba fany ana
emahlongwa	e ma hlongwa
bengqubuzeka	be ngqubuz ek a
angebe	a ng eb e
ngafuza	ng a fuz a
yokugebenga	y o ku gebenga
nidedele	ni dedel e
uyothini	u yo thi ni
wayekhalelani	w a ye khal el a ni
ngokusebenza	ngo ku sebenz a
yokuphumulela	y o ku phumulel a
agcobe	a gcob e
kuyisikhashana	ku y i si khash ana
anqamule	a nqamul e
usangiphindisela	u sa ngi phind is el a
esesimweni	e se si m w eni
wama	w a m a
kungathi	ku nga th i
wami	wa mi
kokwezwi	k o kw e zwi
ibingazange	i b i nga zange
ngiyabheka	ngi ya bhek a
ekhipha	e khiph a
esifudumezi	e si fudumezi
waphashanyiswa	w a phashanyis w a
indesheni	i n desheni
kwakungalindelekile	kw a ku nga lind el ek ile
inyakaza	i nyakaz a
limlandele	li m landel e
amaambulense	a ma ambulense
ningiphe	ni ngi ph e
amcusukela	a m cusuk el a
efikelwa	e fikel w a, e fik el w a
ehlukene	e hluken e
lomuzi	lo mu zi, l o mu zi
baya	ba y a
babekhuluma	ba be khulum a
baye	ba y e
ngalo	nga lo
engakafiki	e nga ka fik i
ngale	nga le
kumenza	ku m enz a
nokwesula	n o kw esul a
kude	ku de
ephila	e phil a
ukuqamba	u ku qamb a
usista	u sista
ngimangele	ngi mangel e
uwashaya	u wa shay a
namabhulukwana	n a ma bhulukw ana
esakwazi	e sa kw azi
lomkhuhlane	lo m khuhlane, l o m khuhlane
sambeka	s a m bek a
mugqa	mu gqa
esivuthayo	e si vuth a yo
dokotela	dokotela
abarimi	a ba rimi, a ba rim i
sezisengiwe	se zi seng iw e
ibhalwe	i bhal w e
iwethusa	i w ethus a
ulokhu	u lokhu
yagxila	y a gxil a
lokufa	l o ku f a
yamashinga	y a ma shinga
ndini	ndini
ngingenza	ngi ng enz a
sishaye	si shay e
kukwasislilly	ku kwa sis lilly
ukuziphambanisa	u ku zi phamban is a
makaphinde	ma ka phind e
ihotela	i hotela
zazikhula	z a zi khul a
seyifisa	se yi fis a
yokunikelela	y o ku nikel el a
amyeke	a m yek e
lwami	lwa mi
uzophila	u zo phil a
izihlahla	i zi hlahla
siyofika	si yo fik a
wazithulela	w a zi thul el a
mkhize	m khize
umama	u mama
ngamanzi	ng a ma nzi
usafa	u sa f a
akavale	a ka val e
basahlikana	ba sa hlik an a
osekwenzekile	o se kw enz ek ile
ekuqaleni	e ku qal eni
sinjena	si nje na
bakuthole	ba ku thol e
kubekhona	ku be kho na
ngazibuka	ng a zi buk a
ngitheni	ngi th e ni
benzakaliswa	b enz akal is w a
amaqakala	a ma qakala
embhedeni	e m bhed eni
kwafika	kw a fik a
nosimakade	no si makade
okumbambile	o ku m bamb ile
yokwesula	y o kw esul a
esenkingeni	e se n king eni
isizwe	i si zwe
yisigxobo	y i si gxobo
esefuna	e se fun a
azibuzele	a zi buz el e
nempepho	n e m peph o
dhlomo	dhlomo
zami	za mi
uyaphi	u y a phi
enganginiphatha	e ng a ngi ni phath a
ngabuza	ng a buz a
kwakumuntu	kw a ku mu ntu
basuthe	ba suth e
washayeka	w a shay ek a
lesisikhundla	le si si khundla
imithi	i mi thi
ungasisiza	u nga si siz a
lowonyaka	lo w o nyaka
abaphatheka	a ba phath ek a
yayibuye	y a yi buy e
isivini	i si vini
ngejubane	ng e jubane
amuzwe	a mu zw e, a mu z w e
egulela	e gul el a
badedelwe	ba dedel w e
abehlukana	a b ehluk an a
bangadilizwa	ba nga diliz w a
esebenza	e sebenz a
emseleni	e m sel eni
uphelela	u phel el a
akalokothi	a ka lokoth i
bafana	b a fan a, ba fana
owangenzela	o w a ng enz el a
ilema	i lema
isihambile	i s i hamb ile
eminye	e mi nye
ngabantu	ng a ba ntu
ubanjwe	u banj w e
kubahlungu	ku b a hlungu
kunomlilo	kun o m lilo
sithi	si thi
akubokwenziwa	a ku bo kw enz iw a
siyazishayela	si ya zi shay el a
msebenzi	m sebenz i
okwemincintiswano	o kw e mi ncint is w an o
ilungise	i lung is e
ngizishiya	ngi zi shiy a
wayeguduza	w a ye guduz a
abakade	a ba kade
awasale	a wa sal e
engasezwa	e nga se zw a
zamanje	za manje
mbulale	m bulal e
noluhlaza	n o luhlaza
liyofika	li yo fik a
enkulu	e n kulu
akabange	a ka bang e, a ka bange
kukhathazwa	ku khathaz w a
angayi	a nga y i
ngamakhaya	ng a ma khaya
unkosazana	u n kos az ana
ngingakutshela	ngi nga ku tshel a
kabasaphefumuli	ka ba sa phefumul i
ngumshini	ngu m shini
ukusizakala	u ku siz akal a
iphoyisa	i phoyisa
kwankala	kwa n kala
nesekela	n e sekel a
uyafika	u ya fik a
okhiye	o khiy e
impendulo	i m pendul o
ibuhlungu	i buhlungu
usebuyile	u se buy ile
elungile	e lung ile
kukadingiswayo	kuka ding is w a yo
wena	we na
sikhuluma	si khulum a
utheni	u th e ni
bona	bo na
sesingavuswa	se si nga vus w a
bantu	ba ntu
izambatho	i z ambath o
uselungiselela	u se lung is el el a
ushevu	u shevu
heqe	heqe
kwathula	kw a thul a
nginedumbe	ngi n e dumbe
ngiyaphinda	ngi ya phind a
ukutholaphi	u ku thol a phi
kwehlule	kw ehlul e
oyiphelezele	o yi phelezel e
esehambe	e se hamb e
kunezinye	ku n e zi nye
esehamba	e se hamb a
sizobambana	si zo bamb an a
wayesewabuza	w a ye se wa buz a
esikorokorweni	e si korokorw eni
usebabuthile	u se ba buth ile
kumfundisi	ku m fund is i
sonke	so nke
babeze	ba be z e
abaya	a ba y a
ubulawa	u bulaw a
imnandi	i mnandi
ubulawe	u bulaw e
benakene	be nak en e
wavala	w a val a
izitshudeni	i zi tshuden i
emsileni	e m sil eni
ecele	e cel e
isu	i su
wabuza	w a buz a
kuliwa	ku l iw a
iso	i so
sithule	si thul e
alotsholwa	a lotshol w a
yikhehla	y i khehla
likhona	l ikhona, l i khona
yokucatshangwa	y o ku catshang w a
wawuvele	w a wu vel e
aseyaphela	a se ya phel a
engingakweluleka	e ngi nga kw elulek a
sekusophe	se ku soph e
nendodana	n e n dod ana
lethembe	l ethemb e
kukithi	ku ki thi
naniwumuzi	n a ni w u mu zi
uyohamba	u yo hamb a
wenza	w enz a
kuqale	ku qal e
kuqala	ku qal a
bathini	ba thi ni
bayakusuka	ba ya ku suk a
wezwakala	w ezw akal a
amaphayiphi	a ma phayiphi
ezikoleni	e zi kol eni
kweluse	kw elus e
esavimbile	e sa vimb ile
okuningi	o ku ningi
esho	e sho
bengasesangweni	be nga se sangw eni
unina	u nina
uhambo	u hamb o
sichaye	si chay e
mubi	mu bi
bangene	ba ngen e
onozwela	o n o zw el a
bangena	ba ngen a
ubuwelelwele	u bu welelwel e
besimlindele	be si m lind el e
ubenzani	u b enz a ni
wayesekhona	w a ye se kho na
umkhondo	u m khondo
mina	mi na
bangabi	ba nga b i
elingene	e li ngen e
uzophumula	u zo phumul a
akuhambi	a ku hamb i
boxoshwa	b o xosh w a
kumamkhize	ku ma m khize
wahosha	w a hosh a
lwaphika	lw a phik a
isivinini	i si vinini
inkulu	i n kulu
basheshe	ba shesh e
lenjoloba	l e n joloba
engephula	e ng ephul a
ukucebisana	u ku ceb is an a
qiniso	qinis o
eyeka	e yek a
libalele	li balel e
uyaphana	u ya ph an a
imbobo	i m bobo
ukudangala	u ku dangal a
ngigqolozele	ngi gqoloz el e
anikine	a nikin e
lize	li z e
nqatshelwa	nqatshel w a
akekho	a k ekho
inhloli	i n hlol i
bengingazi	be ngi ng azi
ukukwenzela	u ku kw enz el a
kubantu	ku ba ntu
zajabula	z a jabul a
wafika	w a fik a
ngiyakhuluma	ngi ya khulum a
bangamthathela	ba nga m thath el a
kunazo	kuna zo
nampa	nam pa
kulomuzi	ku lo mu zi
ezingenamsebenzi	e zi nge na m sebenz i
abasize	a ba siz e
ucije	u cij e
angamdumazi	a nga m dumaz i
asibonge	a si bong e
kwakuyiyo	kw a ku yi yo
ngizonichazela	ngi zo ni chaz el a
lendoda	le n doda, l e n doda
simele	si m el e
enduduzo	e n duduz o
langena	l a ngen a
sibonane	si bon an e
aphuziswe	a phuz is w e
esikhaleni	e si khal eni
ofana	o fan a
kusukela	ku suk el a
lamakhosikazi	l a ma khosi kazi
ihhashi	i hhashi
ngonina	ng o nina
ulaka	u laka
kwakuthunywa	kw a ku thuny w a
ondabeni	o n dab eni
onyesha	o nyesh a
ngibuthiwe	ngi buth iw e
sezinawo	se zi na wo
akhiphe	a khiph e
chokochoko	chokochoko
esule	e sul e
enjani	e njani
siphethwe	si pheth w e
enhla	e n hla
oweqa	o w eq a
elakwambabo	e la kwa mbabo
kwamxina	kw a m xin a
lisashisa	li sa sh is a
laze	l a ze
banokwesaba	ba n o kw esab a
anesisindo	a n e si sind o
aqwashe	a qwash e
ebuka	e buk a
kuze	ku z e
edla	e dl a
okulula	o ku lula
enze	enz e
bavuma	b a vum a, ba vum a
kunguyena	ku ngu ye na
engikwaziyo	e ngi kw azi yo
uyabona	u ya bon a
ayithola	a yi thol a
ayithole	a yi thol e
enzeni	enz e ni
kayiyikholwa	ka yi yi khol w a
wayazi	w a y azi
ngiyamazi	ngi ya m azi
ezitshela	e zi tshel a
seyisebaleni	se yi se bal eni
akwenzeki	a kw enz ek i
sigane	si gan e
emkhawulweni	e m khawul w eni
ngazizwa	ng a zi zw a
kwakhala	kw a khal a
ngamahhelekehle	ng a ma hhelekehle
ayibuke	a yi buk e
emamatheka	e mamathek a
ezicabanga	e zi cabang a
okuthiwa	o ku th iw a
engazange	e nga zange
ongenafu	o ngenafu
bayothelana	ba yo thel an a
bahlwitha	ba hlwith a
esiyedelelisa	e si yedelel is a
sebekhulile	se be khul ile
ayobalunguza	a yo ba lunguz a
bakhubeka	ba khub ek a
avele	a vel e
ngingaba	ngi nga b a
oseyochaza	o se yo chaz a
banginikeza	ba ngi nikez a
wangitshela	w a ngi tshel a
ngingakaxolisi	ngi nga ka xol is i
ayeyibheke	a ye yi bhek e
namaqele	n a ma qele
kumangwane	ku mangw ane
amazinyo	a ma zinyo
zolimi	z o limi
akenze	a k enz e, a kenz e
wakhuza	w a khuz a
kobuye	k o buy e
wavuleka	w a vul ek a
igazi	i gazi
ngidabuka	ngi dabuk a
sekwaze	se kw a ze
selisokhakhayini	se li so khakhay ini
ingena	i ngen a
taku	taku
sengiyadideka	se ngi ya did ek a
ukhama	u kham a
ngangizolindela	ng a ngi zo lind el a
libathe	li ba th e
ngehluke	ng ehluk e
asithole	a si thol e
nantambama	na ntambama
imihlathi	i mi hlathi
awusakhumbuli	a wu sa khumbul i
okunguhluphile	o ku ng u hluph ile
womphako	w o m phak o
bayayehla	ba ya y ehl a
ngibonge	ngi bong e
ayekuyo	a ye ku yo
uzenzelwa	u z enz el w a
ngiyalalela	ngi ya lalel a
khuluse	khuluse
okwesibili	o kw e si bili
wezingane	w e zin gane
kunamaphoyisa	ku na ma phoyisa
mnyamande	mnyamande
ayaziyo	a y azi yo
yayingambhalela	y a yi nga m bhal el a
okwakuhlalwa	o kw a ku hlal w a
bamlalise	ba m lal is e
abayikhulumayo	a ba yi khulum a yo
ngiyamfanisa	ngi ya m fanis a
namhlaba	na m hlaba
bangqumuza	ba ngqumuz a
ufulawa	u fulawa
ahleke	a hlek e
wayengakuthandisisi	w a ye nga ku thand isis i
hhayi	hhayi
sekungathiwa	se ku nga th iw a
noprofessor	n o professor
iminyaka	i mi nyaka
kuwumsebenzi	ku w u m sebenz i
kulenkinga	ku le n kinga
umabatha	u mabatha
befana	be fan a
kukhala	ku khal a
kwesinye	kw e si nye
bebhuquza	be bhuquz a
yedwa	ye dwa
balinde	ba lind e
kwakho	kwa kho
ekhombisa	e khomb is a
kwakhe	kwa khe
ihlanze	i hlanz e
yikhona	yi kho na
ezophatha	e zo phath a
nezinyembezi	n e zi nyembezi
yingqondo	y i n gqond o
welashwa	w elash w a
ngingakabi	ngi nga ka b i
ukuguga	u ku gug a
usumlethele	u s u m leth el e
ekhaya	e khaya
asashiya	a s a shiy a
yavuma	y a vum a
kwaphindwa	kw a phind w a
ngekalishi	ng e kalishi
zibe	zibe
asikasho	a si ka sho
zethuka	z ethuk a
uyaphela	u ya phel a
wethembisa	w ethemb is a
ungumfundisi	u ng u m fund is i
izophuma	i zo phum a
ephengula	e phengul a
lezindwadla	l e zin dwadla
onamandla	o na mandla, o n a ma ndla
ethi	e thi
lowo	lo w o
ethe	e th e
usekhulile	u se khul ile
nalolu	na lo lu
ilula	i lula
lawo	la wo
ngamabandla	ng a ma bandla
bethwele	be thwel e
amarandi	a ma randi
ongakwazi	o nga kw azi
kudliwa	ku dl iw a
iphindiselwe	i phind is el w e
uyahamba	u ya hamb a
enathi	e na thi
kugcwele	ku gcwel e
balandelisa	ba landel is a
yanginika	y a ngi nik a
engenakumemeza	e nge na ku memez a
siyingxenye	si y i n gxenye
bawuvuma	b a wu vum a, ba wu vum a
zindlu	zin dlu
esalungisa	e s a lung is a
lasokhohlo	la so khohlo
zenu	z enu
sekuhleli	se ku hlel i
ngawo	nga wo
ukuthelwa	u ku thel w a
ngawe	nga we
uzumekele	u zumekel e
uqhube	u qhub e
kakungenwa	ka ku ngen w a
ukushaywa	u ku shay w a
izinhlupheko	i zin hluph ek o
ifenisha	i fenisha
ngizomthola	ngi zo m thol a
kwebala	kw e bala
ngisalithola	ngi sa li thol a
bayongena	ba yo ngen a
bambamba	ba m bamb a, b a m bamb a
langanhlanye	langa n hla nye
udube	u dube
kunomsokama	kun o m sokam a
wawakhipha	w a wa khiph a
abanganqoba	a ba nga nqob a
bachaze	ba chaz e
yazi	y azi
yalezizinto	ya le zi zin to
ngiyayazi	ngi ya y azi
ngunkosikazi	ng u n kosi kazi
indodakazi	i n doda kazi
angigibele	a ngi gibel e
sebeyinyathele	se be yi nyathel e
yaze	y a ze
ngolimi	ng o limi
angayazi	a nga y azi
kothi	k o thi
sebengcono	se be ngcono
esingajwayelekile	e si nga jwayel ek ile
itoho	i toho
umakhala	u makhala
ngife	ngi f e
ukuwafundisa	u ku wa fund is a
seniyathethisana	se ni ya theth is an a
ayengafihlelwa	a ye nga fihl el w a
esekhala	e se khal a
angibuyanga	a ngi buy anga
ubathengele	u ba theng el e
ebangwa	e bang w a
kumlethele	ku m leth el e
angisenalo	a ngi se na lo
okudla	o ku dl a
ukholwa	u khol w a
wabika	w a bik a
uziqunga	u zi qung a
unsumpa	u nsumpa
ngihlele	ngi hlel e
nguyise	ng u yise
ngangiqhamokela	ng a ngi qhamok el a
unyembezi	u nyembezi
ababuya	a ba buy a
ifundelwe	i fund el w e
zisemthethweni	zi se m theth w eni
uyisangoma	u y i s angoma
njengabantu	njeng a ba ntu
ukuthatha	u ku thath a
siyamyekela	si ya m yek el a
ngakubo	nga ku bo
ziyamsinda	zi ya m sind a
ongabulala	o nga bulal a
azikhalela	a zi khal el a
ababuleweyo	a ba bule w e yo
kabahambe	ka ba hamb e
ofundisa	o fund is a
ayisathathi	a yi sa thath i
ufunda	u fund a
ayithululele	a yi thulul el e
uyabulawa	u ya bulaw a
akwazi	a kw azi
yizo	yi zo
engahlomile	e nga hlom ile
esethanda	e se thand a
abaqonywa	a ba qony w a
kuyilezo	ku yi le z o
ngonozimanga	ng o no zi ma nga
emafini	e ma f ini
siguli	si gul i
babengaphuthi	b a be nga phuth i
kabasafuni	ka ba sa fun i
kagomere	ka gomere
esingatheni	e si ngath eni
ngiyotshela	ngi yo tshel a
yayivunule	y a yi vunul e
ekhasela	e khas el a
athenge	a theng e
ayo	a yo
ayi	a yi
aye	a y e
saka	saka
umyeni	u m yeni
kuguquza	ku guquz a
eshayela	e shay el a
sezwa	s ezw a
ababone	a ba bon e
uliphiwe	u li ph iw e
zentuthu	z e n tuthu
nokuba	n okuba
wesifazane	w e si faz ane, w e si fazane
imkhombisa	i m khomb is a
ebilokhu	e b i lokhu
ngangiphuzile	ng a ngi phuz ile
kuphunyuke	ku phunyuk e
enjalo	e njalo
oyaziyo	o y azi yo
kumamshengu	ku ma m shengu
wehle	w ehl e
babhinca	ba bhinc a
akhulume	a khulum e
ngaphesheya	nga phesheya
nenja	n e n ja
umathanda	u ma thand a
ngizoba	ngi zo b a
esebuye	e se buye
esebuya	e se buy a
kanjani	ka njani
ngunandi	ng u nandi
nobunzima	n o bu nzima
iluhlaza	i luhlaza
izihlathi	i zi hlathi
angabe	a nga be
kunoluju	kun o lu ju
waqumbelana	w a qumb el an a
oqonde	o qond e
osebenzisa	o sebenz is a
nya	nya
aqalaze	a qalaz e
ngaleso	nga le s o
usaba	u sa b a
ngalesi	nga le si
akasalubhaqi	a ka sa lu bhaq i
ukucima	u ku cim a
kumhlupheki	ku m hluph ek i
esiswini	e si sw ini
afele	a f el e
ngokunye	ng o ku nye
akusekho	a ku se kho
undodana	u ndod ana
kunuka	ku nuk a
emakhanda	e ma khanda
abuze	a buz e
selivelile	se li vel ile
waqinisa	w a qinis a
umkhaya	u m khaya
ukube	u kube
kwakutshama	kw a ku tsham a
icime	i cim e
wavula	w a vul a
okwakwenza	o kw a kwenz a
ilumbo	i lumb o
okhuthalele	o khuthal el e
namathoshi	n a ma thoshi
ndoda	n doda
yema	y em a
ngugamaliyeli	ng u gamaliyeli
bafihla	b a fihl a
ziphelele	zi phelel e
ngesikhathi	ng e si khathi
uyagquma	u ya gqum a
ekulishumpuleni	e ku li shumpul eni
wayipha	w a yi ph a
wasicosha	w a si cosh a
bayayalwa	ba ya yal w a
angimbonanga	a ngi m bon anga
qha	qha
ezinye	e zi nye
esemi	e s em i
eqhudeni	e qhud eni
qho	qho
imifula	i mi fula
liphunga	li phung a
ihambise	i hamb is e
ngamahembe	ng a ma hembe
wasibeka	w a si bek a
kwangena	kw a ngen a
kabonga	ka bonga
okungaka	o ku ngaka
endlini	e n dl ini
ithemba	i themb a
mbuya	m buya
kungabantu	ku ng a ba ntu
kusiniswa	ku sin is w a
ngesibindi	ng e si bindi
sengigule	se ngi gul e
bafuna	b a fun a
akufanele	a ku fan el e, a ku fanel e
lendawo	le n dawo
ungazikhathazi	u nga zi khathaz i
udokotela	u dokotela
ababebuye	a ba be buye
sebeyizibe	se be yi zib e
oyisho	o yi sho
ukuhwelela	u ku hwel el a
akudobele	a ku dob el e
aqhuqhe	a qhuqh e
usenomunye	u se n o mu nye
kungawemali	ku nga w e mali
ungikhiphe	u ngi khiph e
engesilona	e nge si lo na
azokusiza	a zo ku siz a
awuthathwe	a wu thath w e
bayathutha	ba ya thuth a
awela	a wel a
esathi	e sa thi
sibhokile	si bhok ile
zibunjwe	zi bunj w e
unembeza	u nembeza
esegule	e se gul e
bengibusa	be ngi bus a
ubani	u bani
thina	thi na
wabachazela	w a ba chaz el a
bebuyela	be buy el a
ngesamagundane	ng e s a ma gundane
ngahlala	ng a hlal a
ingwadla	i n gwadla
isilibonile	i s i li bon ile
yalifuza	y a li fuz a
izinyosi	i zi nyosi
yaqhubeka	y a qhub ek a
wakwakho	wa kwa kho
ungaka	u ngaka
emakhekheni	e ma khekh eni
namatshwala	n a ma tshwala
nginguzangaza	ngi ng u zangaza
undumezulu	u ndumezulu
esimnandi	e si mnandi
kwaphela	kw a phel a
bathokoza	ba thokoz a, b a thokoz a
ngizwe	ngi zw e
ubuthongo	u bu thongo
kwamethusa	kw a m ethus a
zasethekwini	z a s ethekwini
emuva	e muva, emuva
iqhiyame	i qhiyam e
bebhekisisa	be bhek isis a
zinzima	zi nzima
amenza	a m enz a
elilodwa	e li lo dwa
bangasazi	ba nga s azi
esagwaze	e sa gwaz e
izomhlasela	i zo m hlas el a
ngiyibhekile	ngi yi bhek ile
sesikhona	se si kho na
ayesho	a ye sho
imilomo	i mi lomo
nazo	na z o
nazi	na zi
ijazana	i jaz ana
uhlanganise	u hlangan is e
nalona	na lo na
ngingaphila	ngi nga phil a
esezowabuka	e se zo wa buk a
kumngani	ku m ngani
angisho	a ngi sho
engayithola	e ng a yi thol a
nganeno	nga neno
babesazoyicubungula	ba be sa zo yi cubungul a
esandla	e s andla
ithanda	i thand a
singabendlu	si ng a b e n dlu
iwe	i w e
ngezinto	ng e zin to
untombi	u n tombi
kwakungaze	kw a ku nga ze
uskhemelayi	u skhemelayi
ozakwenza	o z a kw enz a
usigonyela	u si gony el a
nezihlobo	n e zi hlobo
angikusoli	a ngi ku sol i
izinhlamvu	i zin hlamvu
ayisihlanu	a y i si hlanu
akube	a ku b e
kukuphi	ku ku phi
usazoyifunda	u sa zo yi fund a
senginesibinjana	se ngi n e si binj ana
oboti	o boti
kwakuthiwa	kw a ku th iw a
sukanini	suk a nini
enkantolo	e n kantolo
obengilande	o be ngi land e
kuyinto	ku y i n to
ngangibanjwe	ng a ngi banj w e
izandla	i z andla
kwakungangenwangenwa	kw a ku nga ngenwa ngen w a
ngamazwi	ng a ma zw i
umunyu	u munyu
babengazi	ba be ng azi
bonke	bo nke
muni	mu ni
amatshe	a ma tshe
wazimboza	w a zi mboz a
ayefa	a ye f a
sibuye	si buy e
izinqulu	i zin qulu
njengawo	njenga wo
ukuthenga	u ku theng a
kwashabalala	kw a shabalal a
ubuthishela	u bu thishela
emibalabala	e mi bala bala
ecathama	e catham a
ikhofi	i khofi
eqhubeka	e qhubek a
emhlahlweni	e m hlahlw eni
eyenza	e y enz a
zakwabo	za kwa bo
gaga	gaga
ngokuphoxwa	ng o ku phox w a
kungashadwa	ku nga shad w a
ngizoyiletha	ngi zo yi leth a
ju	ju
ulimi	u limi
ngolaka	ng o laka
imigwaqo	i mi gwaqo
yima	yi m a
yilaba	yi la ba
bekungefani	be ku nge fan i
ja	ja
ikade	ikade
thula	thul a
ensinsitheka	e nsinsith ek a
kuncengwe	ku nceng w e
okutshala	o ku tshal a
ofuna	o fun a
ngalizwa	ng a li zw a
sesiyadilizwa	se si ya diliz w a
kukhuluma	ku khulum a
efikile	e fik ile
wavusa	w a vus a
thwala	thwal a
kwake	kw a ke
zagqolozela	z a gqoloz el a
angiyazi	a ngi y azi
ngingafiki	ngi nga fik i
embona	e m bon a
bumsibekele	bu m sibek el e
waphupha	w a phuph a
engihamba	e ngi hamb a
lichitheka	li chith ek a
zemingcwabo	z e mi ngcwab o
sebehlezi	se be hlez i
wayeyigagu	w a ye y i gagu
zingafi	zi nga f i
uyizwa	u yi zw a
kamgci	ka m gci
ngosuku	ng o suku
ibathole	i ba thol e
uqhoshe	u qhosh e
wake	w a ke
uyebo	u yebo
kungutulube	ku ng u tulube
okungahambi	o ku nga hamb i
kokhona	k o kho na
basukume	ba sukum e
ingakufuni	i nga ku fun i
ngumanhlengethwa	ng u manhlengethwa
sebeyaphithizela	se be ya phithiz el a
abaphilayo	a ba phil a yo
bathe	ba th e
kwaqhamuka	kw a qhamuk a
bathi	ba thi
olungasile	o lu nga s ile
abafuthe	a ba futh e
kwaleyompophoma	kwa le y o m pophoma
sami	sa mi
athathwe	a thath w e
sama	s a m a
otshalile	o tshal ile
babekhathele	ba be khathel e
wagcina	w a gcin a
abuyele	a buy el e
uxulu	u xulu
eyisithupha	e y i si thupha
zenziwe	z enz iw e
eseyindoda	e se y i n doda
bathengisa	ba theng is a
kufakwe	ku fak w e
kubo	ku bo
kubi	ku bi
kube	ku b e
bababaze	ba ba baz e
kuba	ku b a
kahle	ka hle
ubuqhaqhaqha	u bu qhaqhaqha
kabafuneki	ka ba fun ek i
iminyovu	i mi nyovu
izinyawowafika	i zi nyawo w a fik a
elishintshile	e li shintsh ile
azozithosela	a zo zi thos el a
ubuze	u buz e
uba	u b a
iyoganela	i yo gan el a
kanjalo	ka njalo
yonke	yo nke
afunde	a fund e
bothina	bo thi na
kangisezukwanda	ka ngi se zu kw and a
yindoda	y i n doda
amadodakazi	a ma doda kazi
unesi	u nesi
isuka	i suk a
yokungadli	y o ku nga dl i
imbala	i m bala
sekuzokuba	se ku zo ku b a
nginamanga	ngi n a ma nga
okokuqala	o k o ku qal a
konyaka	k o nyaka
okwenzekayo	o kw enz ek a yo
wacwebezela	w a cwebezel a
ngokhisimuzi	ng o khisimuz i
kakadeni	kakadeni
embi	e m bi
umbhulelo	u m bhulel o
wagadla	w a gadl a
unswinswinswi	u nswinswinswi
ingani	i nga ni
seliyangesaba	se li ya ng esab a
ingane	i n gane
ekhathi	e khathi
wawuvula	w a wu vul a
evakashele	e vakashel e
adamu	adamu
unkulunkulu	u nkulunkulu
isingili	i si ngili
amthungatha	a m thungath a
linomuntu	li n o mu ntu
okusolayo	o ku sol a yo
engqondweni	e n gqond w eni
eyala	e y al a
ngambuza	ng a m buz a
ayamhlaba	a ya m hlab a
kukubi	ku ku bi
nomdlandla	n o m dlandla
useyambulala	u se ya m bulal a
isizulu	i si zulu
yayibhalwe	y a yi bhal w e
eheleza	e helez a
kuyenzeka	ku y enz ek a
bungehli	bu ng ehl i
esinobhanana	e si n o bhanana
silalaphi	si lal a phi
ngesandla	ng e s andla
ngibheke	ngi bhek e
lowayankosikazi	lo wa ya nkosi kazi
bangakhohlwa	ba nga khohl w a
luvalo	lu valo
ngingakuthola	ngi nga ku thol a
lwakhe	lwa khe
akwaziwa	a kw az iw a
lwakho	lwa kho
bevale	be val e
kwakubhalwe	kw a ku bhal w e
uthisha	u thisha
ohlonipha	o hloniph a
wayekusho	w a ye ku sho
ukokufunda	u ko ku fund a
ngizonigwinya	ngi zo ni gwiny a
abemgwema	a b e m gwem a
ngumagasa	ng u magasa
negama	n e gama
ngakithi	nga ki thi
sezibuye	se zi buy e
iqinisile	i qinis ile
ozohlasela	o zo hlas el a
nompontshi	n o mpontsh i
kwagiya	kw a giy a
imvelele	i m velel e
abasha	a ba sha
wayengakaze	w a ye nga ka ze
wahamba	w a hamb a
singakhuluma	si nga khulum a
amabhasi	a ma bhasi
abaphathe	a ba phath e
ukubhekisisa	u ku bhek isis a
engabaselwe	e nga bas el w e
okweqanda	o kw e qanda
ijazi	i jazi
eyinyanga	e y i nyanga
ukusiwa	u ku s iw a
kwafikwe	kw a fik w e
wabaninda	w a ba nind a
bangakholwa	ba nga khol w a
angithokozi	a ngi thokoz i
angabasiza	a nga ba siz a
ezongenwa	e zo ngen w a
akayolala	a ka yo lal a
ukushekelela	u ku shekelel a
usasukumela	u sa sukum el a
kulungile	ku lung ile
niyitshele	ni yi tshel e
abelokhu	a be lokhu
wazijika	w a zi jik a
uwufuna	u wu fun a
ngizocasha	ngi zo cash a
kangisalikhumbuli	ka ngi sa li khumbul i
izokuthi	i zo ku thi
umzwile	u m zw ile
ingafuni	i nga fun i
zakwethu	za kw ethu
belithi	be li thi
kwakusahanjelwana	kw a ku sa hanj el w an a
eyisinaphungana	e yi s i na phung ana
ngamdlelani	ng a m dl el a ni
anginakukwenza	a ngi na ku kw enz a
okhulumisa	o khulum is a
norifate	n o rifate
u	u
imthele	i m thel e
kungimangalisa	ku ngi mangal is a
okungenzekanga	o ku ng enz ek anga
ngawaseputukezi	ng a wa se putukezi
ayolala	a yo lal a
emile	e m ile
kwesokunxele	kw e s o ku nxele
unguntombi	u ng u n tombi
omanxiwa	o ma nxiwa
adedelwe	a dedel w e
ekhomba	e khomb a
kunjinga	ku njinga
wabaqulela	w a b a qulel a
kanzima	ka nzima
wenzani	w enz a ni
wahlephula	w a hlephul a
kimina	ki mi na
nokwahlukana	n o kw ahluk an a
kuzwe	ku zw e
zabazali	z a ba zal i
bhishi	bhishi
kwemicabango	kw e mi cabang o
erefidimi	e refidimi
lusizo	lu siz o
mntakwethu	m nta kw ethu
steve	steve
etahati	e tahati
bangazifundisi	ba nga zi fund is i
silaza	si laz a
ummbila	u m mbila
esethule	e se thul e
zibuye	zi buy e
zibuya	zi buy a
wayengakhombisi	w a ye nga khombis i
isaba	i sa b a
ukhumbula	u khumbul a
ukhathele	u khathel e
nokukhuluma	n o ku khulum a
imiklomelo	i mi klomel o
uyehle	u y ehl e
abe	a b e
umendo	u mendo
ezigangayo	e zi gang a yo
abo	a bo
babengahambile	ba be nga hamb ile
samphuthuma	s a m phuthum a
angamelana	a nga m el an a
awukuzwe	a wu ku zw e
nalezi	na le zi
kwakusobala	kw a ku so bala
aphawule	a phawul e
ukuhlupheka	u ku hluph ek a
ngezwa	ng ezw a
izokhuluma	i zo khulum a
iyoqeda	i yo qed a
yizingiqi	y i zin giqi
ngempela	ngempela
seyicabanga	se yi cabang a
besifazane	b e si faz ane
isiphuzo	i si phuz o
ngalala	ng a lal a
ngihambile	ngi hamb ile
uzombulala	u zo m bulal a
sebemehlwana	se be me hlw ana
awuboni	a wu bon i
africa	africa
kwentamo	kw e n tamo
asukuma	a sukum a
uyishonisephi	u yi shon is e phi
eya	e y a
emakubo	e ma ku bo
elokuqala	e l o ku qal a
izincwadi	i zin cwadi
ngize	ngi z e
kuzophilwa	ku zo phil w a
esinguninakhulu	e si ng u nina khulu
aphansi	a phansi
amandla	a ma ndla
ngobala	ng o bala
nakudlana	na ku dl ana
abantu	a ba ntu
wayeqonda	w a ye qond a
emkhomazi	e m khom azi
ngemuva	ng e muva
sixoxe	si xox e
uhlobi	u hlobi
wawakhohlwa	w a wa khohl w a
yawagqihisa	y a wa gqih is a
ezazilotshwe	e z a zi lotsh w e, e z a zi lotshw e
lowonkosikazi	lo w o n kosi kazi
uwuthengile	u wu theng ile
nangempela	na ng empela
nothish	n o thish
enginganiweza	e ngi nga ni wez a
kwagovu	kwa govu
uyokwenzenjani	u yo kw enz e njani
isihlahla	i si hlahla
isidumo	i si dumo
kwami	kwa mi
oluphuthumayo	o lu phuthum a yo
ngomhlane	ng o m hlane
babeyibuke	b a be yi buk e
isimo	i si m o
banjani	ba njani
angeze	a ng ez e
emisa	e m is a
eseshaya	e se shay a
iyoshintsha	i yo shintsh a
lifake	li fak e
ayisafiki	a yi sa fik i
okomshayi	o k o m shay i
yingane	y i n gane
izingubo	i zin gubo
uyaqala	u ya qal a
ngikutshele	ngi ku tshel e
yamusa	y a mu s a
esebhekene	e s e bhek en e
baqala	ba qal a
elithwele	e li thwel e
uchule	u chul e
nakhona	na kho na
seyizwile	se yi zw ile
uyohlala	u yo hlal a
ungabhaleli	u nga bhal el i
ewashini	e wash ini
uzozibangela	u zo zi bang el a
okwamanje	o kwa manje
akakazilanduli	a ka ka zi landul i
nokufa	n o ku f a
uyalala	u ya lal a
lakwakhe	l a kw akhe
lakwakho	la kwa kho
kwabuye	kw a buye
avukwe	a vuk w e
kulezonsuku	ku le z o n suku
nomufi	n o mu f i
ukhohlisa	u khohl is a
ngokujwayelekile	ng o ku jwayel ek ile
kuyothi	ku yo thi
ubuso	u bu so
sekuzula	se ku zul a
zizobamhlophe	zi zo b a mhlophe
angifuni	a ngi fun i
azilandele	a zi landel e
wayekwazi	w a ye kw azi
izithelo	i zi thel o
beqhamuka	be qhamuk a
izinhlobonhlobo	i zin hlobonhlobo
oke	o ke
yenzeke	y enz ek e
kulindwe	ku lind w e
yenzeka	y enz ek a
eseqedile	e se qed ile
uhlala	u hlal a
aseyenzile	a se y enz ile
asizona	a si zo na
edlula	e dlul a
emzuma	e m zum a
kustyles	ku styles
umanzi	u ma nzi
wayezibuza	w a ye zi buz a
iqhude	i qhude
sasingakawuthathi	s a si nga ka wu thath i
wayezibhala	w a ye zi bhal a
leyamifothongwane	le ya mi fothongw ane
usathibile	u sa thib ile
siqondeni	si qond e ni
siphethe	si pheth e
ngiyakhala	ngi ya khal a
ishaya	i shay a
ishaye	i shay e
bezihambela	be zi hamb el a
yenziwa	y enz iw a
bebuzwa	be buz w a
zibaba	zi bab a
bafundela	ba fundel a, b a fundel a
ayibhalile	a yi bhal ile
ngiyobhobokela	ngi yo bhobok el a
kugcine	ku gcin e
lensizwa	le n sizwa
usushada	u s u shad a
usuyifuna	u s u yi fun a
usolongi	u solongi
wayekubonephi	w a ye ku bon e phi
bazibonele	ba zi bon el e
engamphendula	e ng a m phendul a
ongubuhle	o ng u bu hle
ekhanda	e khanda
sezinyathela	se zi nyathel a
kapedasuri	ka pedasuri
bukajehova	buka jehova
esebanikile	e se ba nik ile
esadideke	e sa did ek e
yevila	y e vila
waqina	w a qin a
abanye	a ba nye
wayesezimisele	w a ye se zi m is el e
kwakuzongisiza	kw a ku zo ngi siz a
azisebenzele	a zi sebenzel e
ndawo	n dawo
labuye	l a buye
masibisi	ma si bisi
izoqaqeka	i zo qaq ek a
ukuyibizela	u ku yi biz el a
elusile	e lu s ile
nezichwe	n e zi chwe
mama	mama
ukujuluka	u ku juluk a
nokubona	n o ku bon a
lokuvusa	l o ku vus a
bemi	b em i
uxibuyisele	u xibuy is el e
udle	u dl e
iphele	i phel e
esegezile	e se gez ile
angimgijimele	a ngi m gijim el e
beme	be m e, b em e
ugxila	u gxil a
iqale	i qal e
impukane	i m pukane
nelambu	n e lambu
akumangalisi	a ku mangal is i
uzosala	u zo sal a
ambuyisele	a m buy is el e
wasikhipha	w a si khiph a
ngangisebenza	ng a ngi sebenz a
yabaphathizitsha	y a ba phath i zi tsha
sokugcina	s o ku gcin a
ifinyelele	i finyel el e
khisha	khish a
ifinyelela	i finyel el a
ukuzizwa	u ku ziz w a
amahlombe	a ma hlombe
iziboshwa	i zi bosh w a
ukhuza	u khuz a
laliqala	l a li qal a
imeqa	i m eq a
imeqe	i m eq e
iyabheda	i ya bhed a
esayozama	e sa yo zam a
wethemba	w ethemb a, w e themb a
wayeyokuzwa	w a ye yo ku zw a
wethembe	w ethemb e
ngenxa	ng e n xa
babikelwani	ba bik el w a ni
endalini	e n dal ini
bamsiza	ba m siz a
eziko	e ziko
ngesango	ng e s ango
inceku	i n ceku
ka	ka
ke	ke
useba	u s eb a
ungathini	u nga thi ni
ku	ku
kufunwa	ku fun w a
amehlo	a me hlo
umnotho	u m noth o
sikuzwele	si ku zw el e
usigaxamabhande	u si gax a ma bhande
engikucelayoyilo	e ngi ku cel a yo yi lo
wayesemtshelelani	w a ye se m tshel el a ni
amathe	a ma the
umzumbe	u m zumbe
ukulungisa	u ku lung is a
sekwenzenjani	se kw enz e njani
benza	b enz a
nomhlambi	n o m hlamb i
novalo	n o valo
sebetalajwa	se be talaj w a
njengenxenye	njeng e n xenye
sekuwukunyamalala	se ku w u ku nyamalal a
kabili	ka bili
mntwana	m ntwana
wonke	wo nke
amadodana	a ma dod ana
nakimi	na ki mi
ingemukelwanga	i ng emukel w anga
ukhokha	u khokh a
lushayeka	lu shay ek a
ngethaka	ng e thaka
yambhuquzisa	y a m bhuquz is a
izinduku	i zin duku
abasaqungayo	a ba sa qung a yo
sizoma	si zo m a
bathathe	ba thath e
ihora	i hora
yise	yi s e
ngalokhoke	nga lo kh o ke
sezinezilonda	se zi n e zi londa
kuzithenga	ku zi theng a
efanele	e fanel e
emini	e mini
useyayazi	u se ya y azi
inezesheli	i n e z e sheli
ngencwadi	ng e n cwadi
yahamba	y a hamb a
ngeviki	ng e viki
ukwenza	u kw enz a
ukwenze	u kw enz e
ibambane	i bamb an e
sidlale	si dlal e
icala	i cala
ngamibuzo	ng a mi buz o
ungithanda	u ngi thand a
abonge	a bong e
awayikubuyela	a wa yi ku buy el a
wethu	w ethu
ningi	ningi
elimnyama	e li mnyama
ukuzilalela	u ku zi lal el a
abadonse	a ba dons e
limumethe	li mumeth e
ike	i ke
namanje	na manje
lombuzo	lo m buz o
kwegquma	kw e gqum a
liyashelela	li ya shelel a
athufele	a thufel e
anakwe	a nak w e
ngokuqoma	ng o ku qom a
ngaye	nga ye
bacebe	ba ceb e
ucubungule	u cubungul e
ngayo	nga yo
bonga	bong a
wazilandela	w a zi landel a
yayihlezi	y a yi hlez i
ngebhasi	ng e bhasi
alusekho	a lu se kho
babambana	ba bamb an a
kwaphuma	kw a phum a
abaziwayo	a b az iw a yo
niyazibonela	ni ya zi bon el a
walala	w a lal a
abadlali	a ba dlal i
kunjengokuba	ku njeng o kuba
esesikhipha	e se si khiph a
enqiba	e nqib a
webantu	we ba ntu
kuyo	ku yo
ikuthenga	i ku theng a
kuya	ku y a
kuye	ku y e
asekushilo	a se ku sh ilo
uyawabala	u ya wa bal a
azokubamba	a zo ku bamb a
wayisho	w a yi sho
afakane	a fak an e
zingakuhambeli	zi nga ku hamb el i
yasemahlongwa	ya se ma hlongwa
ebloemfontein	e bloemfontein
namahlonyana	n a ma hlony ana
lisamile	li sa m ile
ngigobile	ngi gob ile
izaba	i z ab a
ngomnyaka	ng o m nyaka
bengenamahloni	be nge na ma hloni
ukufiphaza	u ku fiphaz a
siyifanele	si yi fan el e
alize	a li z e
sewubona	se wu bon a
okungasho	o ku nga sho
kuhleliwe	ku hlel iw e, ku hleli w e
esabukhipha	e sa bu khiph a
kwalithathelela	kw a li thathel el a
sekuze	se ku z e
imthukuthelele	i m thukuthel el e
odumile	o dum ile
sebebaningi	se be ba ningi
ingibangile	i ngi bang ile
ngumsebenzi	ng u m sebenz i
ngisebenzisa	ngi sebenz is a
ifake	i fak e
kuzodinga	ku zo ding a
ngazithela	ng a zi thel a
ngaleyonto	nga le y o n to
ngobani	ng o bani
wacondebezela	w a condebez el a
sesiyakhala	se si ya khal a
hhawu	hhawu
kwakukwalillian	kw a ku kwa lillian
sehlukanisiwe	s ehluk an is iw e
siyozingenela	si yo zingenel a, si yo zi ngen el a
acabangisise	a cabang isis e
ukubabhozomela	u ku ba bhozom el a
avuke	a vuk e
ayenza	a y enz a
ukukuqeda	u ku ku qed a
wafisa	w a fis a
ayenze	a y enz e
ezohamba	e zo hamb a
wayeziphekela	w a ye zi phek el a
belusa	b elus a
sengiqhamukela	se ngi qhamuk el a
bazikholisa	ba zi khol is a
bathole	ba thol e
wangidlisa	w a ngi dl is a
amthola	a m thol a
bathola	ba thol a
lisho	li sho
ngokulingana	ng o ku ling an a
kuyaposwa	ku ya pos w a
azingihloniphi	a zi ngi hloniph i
sekuhambe	se ku hamb e
yindlela	y i n dlela
bafise	ba fis e
ogoqiwe	o goq iw e
qwa	qwa
hwalahwala	hwalahwala
yayeneme	y a y enem e
ezidabukela	e zi dabukel a
emalolini	e ma lol ini
ngisahlezi	ngi sa hlez i
ngilapha	ngi lapha
umzimba	u m zimba
yicala	y i cala
kithina	ki thi na
ngilapho	ngi laph o
umhluphelani	u m hluph el a ni
sebengifulathele	se be ngi fulathel e
ayamhlanganyela	a ya m hlangany el a
kumuntu	ku mu ntu
kadolly	ka dolly
ayekubo	a ye ku bo
kungadingeka	ku nga ding ek a
lesisithunzi	le si si thunzi
ezisencane	e zi se ncane
unekhanda	u n e khanda
esenokuzihlalela	e se n o ku zi hlal el a
wakwazi	w a kw az i
umhlangano	u m hlangano
beluqondeni	be lu qond e ni
eharada	e harada
imihla	i mi hla
kuthe	ku th e
bakuphi	ba ku phi
kwesiwa	kw e si wa
kwakungamkhathazi	kw a ku nga m khathaz i
ayezobonakala	a ye zo bon akal a
ngusiqinti	ngu si qinti
ivela	i vel a
kuthi	ku thi
ivele	i vel e
ayilutho	a yi lu tho
kuyaxoxwa	ku ya xox w a
sengithole	se ngi thol e
emzimbeni	e m zimb eni
kuchachaze	ku chachaz e
ibhasi	i bhasi
zaxutshaniswa	z a xutsh an is w a
zihlabe	zi hlab e
ayesefica	a ye se fic a
zibanzi	zi banzi
awusasebenzi	a wu sa sebenz i
salukazi	s alu kazi
usevukile	u se vuk ile
ezinganeni	e zin gan eni
nguhluphile	ng u hluph ile
umthembu	u m thembu
ukushiya	u ku shiy a
awuchele	a w uchel e, a wu chel e
sesiwubonile	se si wu bon ile
ingabe	i nga b e
isende	i sende
sewakhetha	se wa kheth a
amalambu	a ma lambu
wangincisha	w a ngi ncish a
babengamkhohlwa	b a be nga m khohl w a, ba be nga m khohl w a
dlanini	dl a nini
amaphepha	a ma phepha
nengqondo	n e n gqond o
usaphila	u sa phil a
israyeli	israyeli
sekuphindelwa	se ku phind el w a
emyeka	e m yek a
wakude	wa ku de
entsha	e n tsha
wawungezwa	w a wu nge zw a
bezwe	be zw e
bezwa	b ezw a
nakhuya	na khu ya
ubewagcina	u be wa gcin a
uyakwazi	u ya kw azi
siyiyeke	si yi yek e
lena	le na
obemele	o be m el e
sekwexwaye	se kw exway e
ngikhumbula	ngi khumbul a
ukushaya	u ku shay a
beshaqeke	be shaq ek e
bekutshela	be ku tshel a
ngiyamhambisela	ngi ya m hamb is el a
emgwaqeni	e m gwaq eni
lagoge	l a gog e
kamuva	ka muva
besondela	be sondel a
esekuphuzile	e se ku phuz ile
abafana	a ba fana
myeke	m yek e
maqede	maqede
ngiyakutshela	ngi ya ku tshel a
imumethe	i mumeth e
sekuzobadonsa	se ku zo ba dons a
ethini	e thi ni
salokho	sa lo kh o
idlandaba	i dl a n daba
zizitika	zi zi tik a
sibindi	si bindi
ngemfanelo	ng e m fanel o
zithengisiwe	zi theng is iw e
kwahamba	kw a hamb a
ngenza	ng enz a
ngenze	ng enz e
nobhanana	n o bhanana
kuzwakale	ku zw akal e
uzohlala	u zo hlal a
kuhlangene	ku hlangen e
okaqwabe	o ka qwabe
esambane	e s ambane
umhlwazimamba	u m hlwaz i mamba
kwalamanzi	kwa la ma nzi
ngikutshelile	ngi ku tshel ile
axakwe	a xak w e
okwaze	o kw a ze
eshiye	e shiy e
kobani	k o bani
unkala	u n kala
kumenyezela	ku menyez el a
lomunye	l o mu nye
vele	vele
yasegugwini	ya se gugw ini
ukucaca	u ku cac a
umchilo	u m chil o, u m chilo
basondela	ba sondel a
ugranti	u granti
aroni	aroni
kuxaka	ku xak a
umnumzane	u m numzane
esiphakeme	e si phakem e
yisikhwele	y i si khwele
sisaphuma	si sa phum a
bethanda	be thand a
esemdadlana	e se m dadl ana
nezithithibala	n e zi thithibala
inkatha	i n katha
ngemibuzo	ng e mi buz o
lidla	li dl a
uyothi	u yo thi
lidle	li dl e
isiguga	i si gug a
nelengayi	n e lengayi
ngizobabuza	ngi zo ba buz a
zingigqolozele	zi ngi gqoloz el e
omkhulu	o m khulu
ngiyakuhlala	ngi ya ku hlal a
yaphela	y a phel a
uyangcweka	u ya ngcwek a
usemncane	u se m ncane
limi	li m i, limi
amahebezi	a ma hebez i, a ma hebezi
cha	cha
bengimbona	be ngi m bon a
wagxumela	w a gxum el a
bethu	b ethu
bethi	be thi
abazi	a b azi
ukukufihla	u ku ku fihl a
kukwakhe	ku kw akh e
kumame	ku mame
singena	si ngen a
azibonele	a zi bon el e
uzokuba	u zo ku b a
nomamdunge	n o ma mdunge
umfowenu	u m fo w enu
esakubalayo	e sa ku bal a yo
usuvamile	u s u vam ile
qhamu	qhamu
angisaphathi	a ngi sa phath i
samangala	s a mangal a
ehlathini	e hlath ini
kaziphelele	ka zi phel el e
ayelwa	a ye lw a
wayevamise	w a ye vam is e
belimibala	belimibala
oluzokuba	o lu zo ku b a
bacele	ba cel e
waxakwa	w a xak w a
kwenzekani	kw enz ek a ni
seziyamqopha	se zi ya m qoph a
nangesineke	n a nge sinek e
ubethi	u beth i
kudla	ku dl a
afe	a f e
lami	la mi
kudle	ku dl e
ngaphika	ng a phik a
yisifuba	y i si fuba
bakwamanase	ba kwa manase
ngabantwana	ng a ba ntwana
ngazi	ng azi
emoyeni	e moy eni
iqhubeke	i qhub ek e
izilima	i zi lima
akakalilandi	a ka ka li land i
namazinyo	n a ma zinyo
usephenduka	u se phenduk a
ngezinkomo	ng e zin komo
nozethu	n o zethu
bazisane	b az is an e
zibanga	zi bang a
ngiyabezwela	ngi ya b ezw el a
kasawoti	ka sawoti
kwedolobha	kw e dolobha
ubelesele	u belesel e
emhlophe	e mhlophe
sekukhalwa	se ku khal w a
kwenze	kw enz e
yachaphazela	y a chaphazel a
upunda	upunda
kwenza	kw enz a
izisebenzi	i zi sebenz i
amshiya	a m shiy a
madoda	ma doda
ngacabanga	ng a cabang a
ibuthathephi	i bu thath e phi
ukukhathala	u ku khathal a
abengamele	a b engamel e
imizi	i mi zi
zihlobo	zi hlobo
le	le
ngomunye	ng o mu nye
ngalolo	nga lo l o
lo	lo
ongeke	o nge ke
izibhobo	i zi bhob o
ngawugxumela	ng a wu gxumel a
umufi	u mu f i
emzini	e m z ini
ezilukhuni	e zi lukhuni
sabona	s a bon a
esephaphatheka	e se phaphath ek a
egcina	e gcin a
nenyanga	n e nyanga
ehlulwa	e hlul w a
sizithele	si zi thel e
ngolunye	ng o lu nye
ngiwezwile	ngi w ezw ile
eceleni	e cel eni
okwabantu	o kw a ba ntu
ungithumeleni	u ngi thum el e ni
okufanele	o ku fan el e
yiyo	yi yo
wawabuyisela	w a wa buy is el a
ngizakubulalela	ngi za ku bulal el a
nonyoko	n o nyoko
nanamhla	na na m hla
nambili	na m bili
kwahlala	kw a hlal a
uyayithanda	u ya yi thand a
wathatha	w a thath a
ukokutshela	u ko ku tshel a
cwi	cwi
kodlalwa	k o dlal w a
elwayiza	e lwayiz a
abazali	a ba zal i
uvulela	u vul el a
abazala	a ba zal a
kusizakala	ku siz akal a
owayebhale	o w a ye bhal e
ukuhlomela	u ku hlomel a
masisukume	ma si sukum e
bayazi	ba y azi
kulobutshwala	ku lo bu tshwala
lihanjiswe	li hanj is w e
singabokufika	si nga bo ku fik a
eseza	e s ez a
wachela	w a chel a
emane	e mane
cishe	cishe
uyadabuka	u ya dabuk a
abazifunayo	a ba zi fun a yo
wokushokusha	w o ku shokush a
ezithele	e zi thel e
bemnaka	be m nak a
nalokhokuhlupha	na lo kh o ku hluph a
esezwa	e se zw a
edolobheni	e dolobh eni
usefana	u se fan a
ubengayazi	u be nga y azi
umamdunge	u m amdunge, u mamdunge
ezihlalele	e zi hlal el e
isinkwa	i si nkwa
ukuyichazela	u ku yi chaz el a
usiza	u siz a
usize	u siz e
yogulayo	y o gul a yo
usizi	u sizi
usizo	u siz o
izigqoko	i zi gqok o
sengizombophela	se ngi zo m boph el a
bezele	be z el e
ubuphukuphuku	u bu phukuphuku
ngiyahamba	ngi ya hamb a
elisikhohlisa	e li si khohl is a
iziyalo	i zi yal o
ozangaza	o zangaz a
ingamashumi	i nga ma shumi
nelikamashobana	n e lika ma shob ana
ulivila	u li vila
munye	mu nye
ude	u de
elikholwa	e li khol w a
kwagcina	kw a gcin a
eliboshelwe	e li bosh el w e
ngenziwa	ng enz iw a
yena	ye na
ethukile	e thuk ile
yikushisa	y i ku shisa
azisale	a zi sal e
yikumamatheka	yi ku mamathek a
zikhona	zi kho na
bayophuma	ba yo phum a
ukuthola	u ku thol a
ingenelwe	i ngen el w e
ngingalazi	ngi nga l azi
ezinhle	e zin hle
bazilile	b a zi lil e
kawazi	ka w azi
ngolwesihlanu	ng o lw e si hlanu
isitimela	i si timela
imfucuza	i m fucuza
esibabayo	e si bab a yo
yokuphunyula	y o ku phunyul a
esibhedlela	e si bhedlela
nasezinkantolo	na se zin kantolo
nosizo	n o siz o
sesiyolinda	se si yo lind a
kushunqa	ku shunq a
kulawomadwala	ku la w o ma dwala
ngamelwe	ng a m el w e
ekucabanga	e ku cabang a
zonke	zo nke
waziphekela	w a zi phek el a
athengisele	a theng is el e
wawufunda	w a wu fund a
ebesiwuphethe	e be si wu pheth e
kuleli	ku le li
egqiha	e gqih a
ukuphumulela	u ku phumulel a
ebhekekayo	e bhek ek a yo
esasilangazelela	e s a si langazel el a
kwendlu	kw e n dlu
samkhanyisa	s a m khany is a
waphambanisa	w a phamban is a
kuyazalwa	ku ya zal w a
shi	shi
nasemhlane	na se m hlane
kwendle	kw e n dle
umlomo	u m lomo
encane	e ncane
ukungabaza	u ku nga baz a
oyedwa	o ye dwa
umkhaba	u m khaba
engayi	e nga y i
iphuza	i phuz a
yaqalaza	y a qalaz a
ngemisebenzi	ng e mi sebenz i
leli	le li
lobo	lo b o
ubaba	u baba
engingasazi	e ngi nga s azi
lelo	le l o
uzalwa	u zal w a
ubunzima	u bu nzima
nangokufana	na ng o ku fan a
ukugibela	u ku gibel a
angizalwanga	a ngi zal w anga
endaleni	e n dal eni
buthelezi	bu thelezi
ngumshikashika	ng u m shika shika
lobu	lo bu
ndlela	n dlela
wayezofuna	w a ye zo fun a
nihambe	ni hamb e
ethuke	e thuk e
ethuka	e thuk a
wawa	w a w a
yombhulelo	y o m bhulel o
iconsa	i cons a
sesihlola	se si hlol a
uyise	u yise
bamenze	ba m enz e
ngiyabakitaza	ngi ya ba kitaz a
wakhutshwa	w a khutsh w a
sikhala	si khal a
ngumzukazuku	ng u m zukazuku
ngeminyaka	ng e mi nyaka
kusenamanxeba	ku se n a ma nxeba
akathanda	a ka thand a
ileyo	i le y o
thushu	thushu
amacala	a ma cala
akufananga	a ku fan anga
ngikhohlwe	ngi khohl w e
esiliva	e siliva
kumanjena	ku manje na
kulesisinyokotho	ku le si si nyokotho
escottburgh	e scottburgh
lengane	l e n gane
udamane	u damane
sebeyashudula	se be ya shudul a
bekwazi	be kw azi
lesisicelo	le si si cel o
ukwedlulisa	u kw edlul is a
bambone	ba m bon e
ngumanzuza	ng u manzuza
zimlibazisa	zi m libaz is a, zi m libazis a
ohlwathizayo	o hlwathiz a yo
qalaqala	qala qal a
useyindoda	u se y i n doda
esibayeni	e si bay eni
okwakungathiwa	o kw a ku nga th iw a
yindilingakazi	y i n dilinga kazi
unkabi	u n kabi
eyohlaba	e yo hlab a
sibonwa	si bon w a
wanquma	w a nqum a
basebenzisa	b a sebenz is a
ngamayezi	ng a ma yezi
akasayisuseli	a ka sa yi sus el i
adinge	a ding e
akazange	a ka zang e
behlangene	be hlangen e
ayisengangawo	a yi se nganga wo
sikhohlane	si khohl an e
usefika	u se fik a
ziyinkinga	zi y i n kinga
idwala	i dwala
ekade	e kade
eseduze	e se duze
niki	niki
gazi	gazi
izikhathi	i zi khathi
ngithande	ngi thand e
okukhombisayo	o ku khomb is a yo
eslangspruit	e slangspruit
weza	w ez a
yilawo	yi la w o
ngithole	ngi thol e
akakawufaki	a ka ka wu fak i
akwenzekanga	a kw enz ek anga
angazanga	a ng az anga
ngemoto	ng e moto
umnyama	u mnyama
onake	o nak e
akuphume	a ku phum e
odakeni	o dak eni
nokuyenza	n o ku y enz a
nokunye	n o ku nye
ukuncokola	u ku ncokol a
wayezwa	w a ye zw a
asebejwayelene	a se be jwayel en e
baphumelele	ba phumelel e
ngukuthi	ng ukuthi
ukuphatha	u ku phath a
wezalukazi	w e z alu kazi
ukuxoxaxoxa	u ku xoxaxox a
utom	u tom
sidakiwe	si dak iw e
ikhuluphele	i khuluphel e
wahlehlela	w a hlehl el a
ziyashaywa	zi ya shay w a
kwakhohleka	kw a khohl ek a
imikhonto	i mi khonto
umkakho	u m ka kho
kuqhelile	ku qhel ile
ayamkhumbula	a ya m khumbul a
umkakhe	u m ka khe
ngizibeke	ngi zi bek e
imzalele	i m zal el e
eqeda	e qed a
ezwe	e zw e
bazophindela	ba zo phind el a
ezwa	e zw a
asilingise	a si ling is e
kabi	ka bi
wenela	w enel a
enolaka	e n o laka
kwasekuzokhuluma	kw a se ku zo khulum a
yedlula	y edlul a
umntwana	u m ntw ana
uvalo	u valo
akhungatheke	a khungath ek e
ehluleke	e hlul ek e
sibatshela	si ba tshel a
sebeqala	se be qal a
kwamhlongo	kwa m hlongo
esangoma	e s angoma
kamfowabo	ka m fo wa bo
odokotela	o dokotela
sengishintshelwa	se ngi shintsh el w a
wakhipha	w a khiph a
iyibukele	i yi buk el e
sajuluka	s a juluk a
ngethuka	ng ethuk a
azongena	a zo ngen a
uhambe	u hamb e
lika	lika
uhamba	u hamb a
induku	i nduku
athi	a thi
ulalele	u lalel e
kuyaphithizelwa	ku ya phithiz el w a
asinamfundisi	a si na m fund is i
nemikhuba	n e mi khuba
ingasho	i nga sho
akachithanga	a ka chith anga
ngamatshe	ng a ma tshe
nenkosikazi	n e n kosi kazi
ngishilo	ngi sh ilo
ukulindiswa	u ku lind is w a
nje	nje
esasibhaklazeke	e s a si bhaklaz ek e
otshele	o tshel e
otshela	o tshel a
alibhekisisa	a li bhek isis a
ukupheka	u ku phek a
nomama	n o mama
nothoko	n o thok o
sekuyikho	se ku yi kho
zizizele	zi zi zel e
elaba	e laba
yesalukazi	y e salukazi, y e s alukazi
incane	i ncane
lawuthobela	l a wu thob el a
engingakusho	e ngi nga ku sho
okukhanyisile	o ku khany is ile
wabenzela	w a b enz el a
siphume	si phum e
ngalobobusuku	nga lo b o bu suku
isiziwe	i siz iw e
ngomuthi	ng o mu thi
maningi	ma ningi
nokukhokhiswa	n o ku khokh is w a
kuzokwehlisa	ku zo kw ehl is a
inkulumo	i n kulum o
wangimba	w a ngi mb a
zimklwebha	zi m klwebh a
selimi	se li m i
inhlinini	i n hlinini
nakwendlala	na kw e n dlala
eselele	e se lel e
makuxoxwe	ma ku xox w e
wangephula	w a ng ephul a
woziyisa	w o zi y is a
ayakuthanda	a ya ku thand a
zedrama	z e drama
kwakufuneka	kw a ku fun ek a
bebheke	be bhek e
bebheka	be bhek a
kusasa	ku sasa
sekuthe	se ku th e
sekuthi	se ku thi
uzofike	u zo fik e
ukumchazela	u ku m chaz el a
owayecabangile	o w a ye cabang ile
ngangiqala	ng a ngi qal a
kunini	ku nini
umonakalo	u m on akal o
sekudlule	se ku dlul e
eseseduze	e se se duze
okwenzeka	o kw enz ek a
nokunyamalala	n o ku nyamalal a
ngamaqembu	nga ma qembu
kwakuzwakale	kw a ku zw akal e
kwakuzwakala	kw a ku zw akal a
behlala	be hlal a
ikhona	i kho na
ngiyigula	ngi y i gula
yamnqumela	y a m nqum el a
nodolly	n o dolly
sekuntambama	se ku ntambama
sezinzima	se zi nzima
bengangibuyisela	be nga ngi buy is el a
ngingakadubuli	ngi nga ka dubul i
makhulu	ma khulu
ungafika	u nga fik a
isipho	i si ph o
agugele	a gug el e
njengohlanya	njeng o hlanya
usuyalwa	u s u y al w a
ube	u b e
iyamthanda	i ya m thand a
lomfanyana	l o m fany ana
kuvelaphi	ku vel a phi
sengiyaxoshwa	se ngi ya xosh w a
nomshado	n o m shad o
mnandi	mnandi
ayikedluli	a yi k edlul i
besingehlukene	be si ng ehluk en e
bakageorge	baka george
yingakho	yi nga kho
uyezwa	u y ezw a
kungacelwanga	ku nga cel w anga
emhlanganweni	e m hlangan w eni
baphanga	ba phang a
makazivumise	ma ka zi vum is e
fiyo	fiyo
kuzwakele	ku zw akel e
izinwele	i zi nwele
wehlulwe	w ehlul w e
nwi	nwi
licashe	li cash e
ngazikile	ng a zik ile
khulu	khulu
nosikhuni	n o si khuni
wezwa	w ezw a
ngeyesigodlo	ng e y e si godlo
limkhumbuze	li m khumbuz e
kokuba	k o kuba
ngibhobozile	ngi bhoboz ile
angambulala	a nga m bulal a
yokulindela	y o ku lind el a
isebenza	i sebenz a
nezokuhlobisa	n e z o ku hlob is a
bamnike	b a m nik e
ayowubeke	a yo wu bek e
bayothungatha	ba yo thungath a
ihlupha	i hluph a
bamtshele	ba m tshel e
uvulekile	u vul ek ile
ngikusize	ngi ku siz e
lamaphuzu	l a ma phuzu, la ma phuzu
abazukuhlala	a ba zu ku hlal a
kwelikamlotha	kw e lika m lotha
nkwe	n kwe
nasebabanango	na se baba nan g o
umacbeth	u macbeth
bakuhlupha	ba ku hluph a
unogwaja	u nogwaja
kangcono	ka ngcono
igane	i gan e
navolovolwana	na volovolw ana
bhulose	bhulose
abakhohlisanayo	a ba khohl is an a yo
uyishiye	u yi shiy e
isilokhu	i s i lokhu
mancinza	ma ncinz a
oluphilayo	o lu phil a yo
umamshengu	u mamshengu
angawaqondi	a nga wa qond i
sebezitika	se be zi tik a
iyasheshisa	i ya shesh is a
lungekho	lu nge kho
nezifamona	n e zi famona
kwenduku	kw e n duku
babeyogcina	b a be yo gcin a
ngesikhulu	ng e si khulu
kwahlaluka	kw a hlaluk a
ukubuminya	u ku bu miny a
azicelile	a zi cel ile
ebona	e bon a
ayoyiphuthaza	a yo yi phuthaz a
uzokwakhiwa	u zo kw akh iw a
wazikhuza	w a zi khuza
akhumbule	a khumbul e
ngamanqina	ng a ma nqina
yaqhuba	y a qhub a
abuye	a buy e
asebuza	a se buz a
zikababa	zika baba
uyihlo	u yihlo
azumeke	a zum ek e
ungasho	u nga sho
welusa	w elus a
bayicela	ba yi cel a
ngizolungisa	ngi zo lung is a
ngakwelinye	nga kw e li nye
ma	ma
wenzeni	w enz e ni
emahlombe	e ma hlombe
engadlanga	e nga dl anga
kwakukuningi	kw a ku ku ningi
ubefike	u be fik e
yezindandatho	y e zin dandatho
bhoka	bhok a
ukwesula	u kw esul a
iyabona	i ya bon a
bengingayeka	be ngi nga yek a
ubhala	u bhal a
ukumzuma	u ku m zum a
eyedwa	e ye dwa
ezikhona	e zi kho na
ukuba	ukuba, u ku b a
ezinqoleni	e zin qol eni
izilwane	i zi lwane
ubengambambele	u be nga m bamb el e
sekuthanda	se ku thand a
kuyise	ku yise
asenzise	a s enz is e
yamvimba	y a m vimb a
ehefuzela	e hefuz el a
uvalelise	u valelis e
wayengakhulumi	w a ye nga khulum i
alikadluli	a li ka dlul i
esikhuntile	e si khunt ile
badle	ba dl e
ngiyakukhuza	ngi ya ku khuz a
bavuthwa	ba vuth w a
phezu	phezu
emanzi	e ma nzi
ngasedandi	nga se dandi
ukungithungathela	u ku ngi thungath el a
lababantu	la ba ba ntu
iwanelisa	i w anel is a
nembodla	n e m bodla
akakwazi	a ka kw azi
kukhona	ku kho na
ngunkulunkulu	ng u nkulu nkulu
okwakuvelela	o kw a ku vel el a
manje	manje
exobho	e xobho
ima	i m a
sebeyafisa	se be ya fis a
nezinhlonze	n e zin hlonze
ukubuza	u ku buz a
angakuphika	a nga ku phik a
emthethweni	e m thethw eni
siyawufuna	si ya wu fun a
ngalutho	nga lu tho
ubungani	u b u ngani
kuhle	ku hle
lesisizwe	le si si zwe
awumenzeli	a wu m enz el i
uyathakathwa	u ya thakath w a
ababona	a ba bon a
lishaya	li shay a
esengumfana	e se ng u m fana
elikhulu	e li khulu
izindlela	i zin dlela
lento	le n to
nochitha	n o chith a
inyamalala	i nyamalal a
ngabathathu	ng a ba thathu
yomuntu	y o mu ntu
inyanda	i nyanda
kubuyelwe	ku buy el w e
ngumfazi	ng u m fazi
sebezowaciba	se be zo wa cib a
lukhuni	lukhuni
esesemabangeni	e se se ma bang eni
nendaba	n e n daba
wawudidizela	w a wu didizel a
ilori	i lori
ngezindlela	ng e zin dlela
wayehamba	w a ye hamb a
esaba	esab a
wethuka	w ethuk a
yingalesosikhathi	yi nga le s o si khathi
ngubuthatha	ng u bu thatha
abekucele	a be ku cel e
osumbonile	o s u m bon ile
umqondo	u m qond o
ithuna	i thun a
kuyabuswa	ku ya bus w a
kuwo	ku wo
izikhonkwane	i zi khonkw ane
ngiphela	ngi phel a
basebancane	ba se ba ncane
baxinwe	ba xin w e
wumuthi	w u mu thi
ubakhwabanisele	u ba khwaban is el e, u ba khwabanis el e
ukutshela	u ku tshel a
iyiqiniso	i y i qinis o
uzokhula	u zo khul a
isiludwamba	i s i lu dwamba
awungazi	a wu ng azi
ngisakhuluma	ngi sa khulum a
okudala	o ku dal a
uphume	u phum e
wobufakazi	w o bu fakaz i, w o bu fakazi
uphuma	u phum a
ikuphi	i ku phi
nicabanga	ni cabang a
ekhombisisa	e khombis is a
ababethuthelekela	a ba be thuthel ek el a
ujosefa	u josefa
izombulala	i zo m bulal a
ngumniniyo	ng u m nini yo
kuzokoba	ku zo k ob a
yasesikoleni	yasesikoleni
kufikwa	ku fik w a
liqala	li qal a
liqale	li qal e
wangikhulula	w a ngi khulul a
akungeni	a ku ngen i
ayesemaningi	a ye se ma ningi
abakhwenyana	a ba khwenyana
uyoze	u yo z e, u yo ze
onjani	o njani
udla	u dl a
amaphephandaba	a ma phepha n daba
kanti	kanti
tom	tom
eqe	eq e
ngomgqibelo	ng o m gqibel o
bikho	bikho
siqeda	si qed a
uwunikwe	u wu nik w e
nedombolo	n e dombolo
engingemuva	e ngi ng emuva
umuzi	u mu zi
sakhiwe	s akh iw e
walandiswa	w a land is w a
kukhonjwa	ku khonj w a
ubanike	u bani ke
ngingemxoxele	ngi nge m xox el e
ukusa	u ku s a
singahlanganiswa	si nga hlangan is w a
sekusho	se ku sho
yithonya	y i thonya
ukuqundeka	u ku qund ek a
akumsizanga	a ku m siz anga
ubuhlungu	u buhlungu
isangoma	i s angoma
ngisafuna	ngi sa fun a
ngamzuza	ng a m zuz a
umkhulu	u m khulu
sebehleli	se be hlel i
ungcobo	u ngcobo
nemfolozi	n e m folozi
ngaziphi	ng a z iphi
engabe	e nga b e
ephosisa	e phos is a
abangayazi	a ba nga y azi
izichwe	i zi chwe
ukhona	u kho na
selishintshile	se li shintsh ile
ngiyamtshela	ngi ya m tshel a
omuhle	o mu hle
ngiyabuza	ngi ya buz a
konakeleni	k on akel e ni
nepeni	n e peni
akafunde	a ka fund e
ungizwe	u ngi zw e
ngahamba	ng a hamb a
wakhohlwa	w a khohl w a
impela	impela
uphi	u phi
ngokudlula	ng o ku dlul a
upha	u ph a
uzazi	u z azi
umshini	u m shini
izinkomo	i zin komo
kumenyezelwe	ku menyez el w e
uzokhuphuka	u zo khuphuk a
nsizwa	n sizwa
eziqwini	e zi qw ini
ongayithandi	o nga yi thand i
yangenza	y a ng enz a
ziyabila	zi ya bil a
ziyangigegela	zi ya ngi geg el a
nabanalesisifo	n a ba na le si si f o
ngamuthi	nga mu thi
ayesekuzwile	a ye se ku zw ile
ngabandayo	ng a band a yo
usuphehlwa	u s u phehl w a
akalahlwa	a ka lahl w a
ehovisi	e hovisi
iwaphihlizeka	i wa phihliz ek a
kwathi	kw a thi
yebo	yebo
ungitshela	u ngi tshel a
ungitshele	u ngi tshel e
ukusintinyela	u ku si ntinyel a
osefike	o se fik e
wawatshela	w a wa tshel a
nokungaboni	n o ku nga bon i
basuke	ba suk e
izulu	i zulu
emvilophini	e m viloph ini
iphindiwe	i phind iw e
basuka	ba suk a, b a suk a
ogulayo	o gul a yo
ngoba	ngoba
ishe	i sh e
ngenyanga	ng e nyanga
bangamaqhawe	ba ng a ma qhawe
sewacabanga	se wa cabang a
umdlaka	u m dlaka
isho	i sho
imbiza	i m biza
ngababili	ng a ba bili
ayesezama	a ye se zam a
isalukazi	i s alu kazi
kudidizelwa	ku didiz el w a
yakwamncube	ya kwa m ncube
nangapha	na ngapha
abadala	a ba dala
umshana	u m shana
ibhema	i bhem a
zibiza	zi biz a
kwe	kw e, kwe
ungazifaka	u nga zi fak a
sikhombe	si khomb e
eziboshwe	e zi bosh w e
kwengozi	kw e n gozi
wadlala	w a dlal a
kumfana	ku m fana
sengiyasebenza	se ngi ya sebenz a
igcinekile	i gcin ek ile
isithunzi	i si thunzi
kungafika	ku nga fik a
ukusebenzela	u ku sebenz el a
usuhlebeke	u s u hleb ek e
nezipopolo	n e zi popol o
asezikhohliwe	a se zi khohl iw e
mazisize	ma zi siz e
mnganami	m ngan a mi
wekamelo	w e kamelo
ukubona	u ku bon a
lomame	l o mame
abafowethu	a ba fo w ethu
igilo	i gilo
utozi	u tozi
ebuza	e buz a
ngukuba	ng ukuba
ezolimala	e zo limal a
kanzimande	ka nzima n de
ayibambi	a yi bamb i
wagqanqula	w a gqanqul a
nengingakubonisa	n e ngi nga ku bon is a
nomshwalense	n o m shwalense
babheke	ba bhek e
ngosiko	ng o siko
emathekwini	e ma thekw ini
bayothenga	ba yo theng a
ngumnu	ng u m nu
kusacingwa	ku sa cing w a
ukhuleka	u khulek a
oweloli	o w e loli
bengizothini	be ngi zo thi ni
omunye	o mu nye
emabhantshini	e ma bhantsh ini
uchitha	u chith a
azimnakile	a zi m nak ile
ishwa	i shwa
ngelikade	ng e li kade
usalokhu	u sa lokhu
siyovuka	si yo vuk a
ngaphuma	ng a phum a
sadilizelwani	s a diliz el w a ni
endodakazini	e n doda kaz ini
nonkulunkulu	n o nkulu nkulu
luphathelene	lu phath el en e
ethekwini	e thekw ini
bamisa	ba m is a
angamqeda	a nga m qed a
lokobakhombisa	l o k o ba khomb is a
kuphakathi	ku phakathi
iyabonakala	i ya bon akal a
nembekamuzi	n e m bek a mu zi
ubekusho	u be ku sho
kwakukhanya	kw a ku khany a
nentombazane	n e n tombaz ane
akasezukubuya	a ka se zu ku buy a
ovelayo	o vel a yo
nakuyona	na ku yo na
ukudla	u ku dl a
sigcwele	si gcwel e
waqinisela	w a qinisel a
imininingwane	i mi niningwane
esesele	e se sel e
sewufuthekile	se wu futh ek ile
ngani	nga ni
sincane	si ncane
empilweni	e m pil w eni
ingalibala	i nga libal a
kuyokwenzeka	ku yo kw enz ek a
ungumthakathi	u ng u m thakath i
uyihlozala	u yi hlozal a
umnika	u m nik a
liyofudumala	li yo fudumal a
angisandi	a ngi s and i
singagqilazwa	si nga gqilaz w a
ufodo	u fodo
selingayithela	se li nga yi thel a
ngosithembiso	ng o si themb is o
abebengaqonde	a be be nga qond e
zokukhokhela	z o ku khokh el a
somhlangano	s o m hlangan o
futhi	futhi
sibalayela	si ba layel a
enanimbiza	e n a ni m biz a
bamane	ba mane
kabhanoyi	ka bhanoyi
ncane	ncane
kuyokhulunywa	ku yo khuluny w a
uvele	u vele
singasazi	si nga s azi
buthule	bu thul e
wayeseshiyekile	w a ye se shiy ek ile
iyabiza	i ya biz a
isezinyaweni	i se zi nyaw eni
akhwelephi	a khwel e phi
uyaziphendula	u ya zi phendul a
ezixoshile	e zi xosh ile
imqhofoza	i m qhofoz a
ibuza	i buz a
nelilodwa	n e li lo dwa
lenqola	l e n qola
eliya	e li y a
asiphuthume	a si phuthum e
kwakungasasizi	kw a ku nga sa siz i
ngizozama	ngi zo zam a
wayeyithatha	w a ye yi thath a
lwencwadi	lw e n cwadi
ngazini	ng azi ni
kubizwe	ku biz w e
emnyango	e m nyango
kubizwa	ku biz w a
angabuyi	a nga buy i
lempi	le m pi, l e m pi
isibaya	i si baya
ibalisa	i bal is a
ungangitsheli	u nga ngi tshel i
likhalile	li khal ile
yamandwandwe	y a ma ndwandwe
sidinga	si ding a
athukuthele	a thukuthel e
sesejwayelene	se s ejway el en e
wawusumukhulu	w a wu s u mu khulu
ngiyomjezisa	ngi yo m jez is a
zixoxelwa	zi xox el w a
sezilapha	se zi lapha
uthengise	u theng is e
kubuswa	ku bus w a
ngimdlulisele	ngi m dlul is el e
nakodokotela	na k o dokotela
ekhona	e kho na
sibukane	si buk an e
olukhuni	o lukhuni
nobhulose	n o bhulose
ekuthini	e ku th ini
yakho	ya kho
lwendlala	lw e n dlala
imdedele	i m dedel e
abalapha	a ba lapha
ngingenwe	ngi ngen w e
no	n o
na	na
ophelela	o phel el a
ngazibonela	ng a zi bon el a
kamhlophe	ka mhlophe
akakhulunyiswa	a ka khuluny is w a
sebezosizakala	se be zo siz akal a
ahlabe	a hlab e
ababonanga	a ba bon anga
esewuphethe	e se wu pheth e
ukuntula	u ku ntul a
babemvakashela	ba be m vakash el a
zaziyazi	z a zi y azi
bayakuthanda	ba ya ku thand a
yiyona	yi yo na
kuleminyaka	ku le mi nyaka
bamba	bamb a
bakhwenyana	ba khwenyana
umfaniseni	u m fan is e ni
ndaba	n daba
sokuhleba	s o ku hleb a
uyahishwa	u ya hish w a
omamba	o mamba
likagogo	lika gogo
eziphambi	e zi phambi
uyazikhohlisa	u ya zi khohl is a
emadwaleni	e ma dwal eni
baxoxa	ba xox a
uphakamisa	u phakam is a
cetshwayo	cetshwayo
mnyama	mnyama
izimpahla	i zim pahla
uzongithethisa	u zo ngi theth is a
uyibeka	u yi bek a
cosololo	cosololo
waqoma	w a qom a
waluqala	w a lu qal a
nendlu	n e n dlu
ngasola	ng a sol a
ngizophindela	ngi zo phind el a
akuzona	a ku zo na
umkhonto	u m khonto
yale	ya le
yalo	ya lo
nezimbuzi	n e zim buzi
sezigwinya	se zi gwiny a
eseyobheka	e se yo bhek a
kepha	kepha
sayo	sa yo
bake	ba ke
ubuye	u buye
ngalabomadlebhekile	nga la b o ma dl e bhek ile
namahlulana	n a ma hlul ana
ingqondo	i n gqond o
gege	gege
egcotshwayo	e gcotsh w a yo
umashiyakukhalwa	u ma shiy a ku khal w a
awuzange	a wu zange
siphele	si phel e
kwadlula	kw a dlul a
ukuzwa	u ku zw a
komoya	k o moya
angihambe	a ngi hamb e
ongemuntu	o nge mu ntu
lizomceba	li zo m ceb a
yozi	yozi
baningi	ba ningi
wachaza	w a chaz a
ulindele	u lind el e
esibonakalayo	e si bon akal a yo
ezinhlamvini	e zin hlamv ini
uhlwelwa	u hlwel w a
baqalaqalaza	ba qalaqalaz a
ikhuphukela	i khuphuk el a
kwakungukuthi	kw a ku ng ukuthi
nhloko	n hloko
bangitshele	ba ngi tshel e
ungazi	u ng azi
bembe	b emb e
ombonayo	o m bon a yo
engakuguqulanga	e nga ku guqul anga
ehene	e hen e
ifile	i f ile
iqedile	i qed ile
mamdunge	ma m dung e
sekufiwa	se ku f iw a
emva	emva
wethembele	w ethemb el e
uvamise	u vamis e
ishiwo	i sh iw o
ukushumayela	u ku shumayel a
olixova	o li xov a
ogcwele	o gcwel e
udlawu	u dlawu
ziliphuzi	ziliphuzi
azame	a zam e
siye	si y e
siya	si y a
ilandelwa	i landel w a
yesizulu	y e si zulu
ezemisebenzi	e z e mi sebenz i
ngiyakhumbula	ngi ya khumbul a
wande	w and e
yizinhlungu	y i zin hlungu
kwalolo	kwa lo l o
bathenge	b a theng e, ba theng e
gombela	gomb el a
kwakhona	kwa kho na
selibonakala	se li bon akal a
ezayo	e z a yo
ombhede	o m bhede
ithamo	i tham o
sewuqale	se wu qal e
wakucabanga	w a ku cabang a
nasehotela	na se hotela
izifele	i zi f el e
kutuswa	ku tus w a
ilokho	i lo kh o
azibona	a zi bon a
ilokhu	i lokhu
sisebenza	si sebenz a
ohlonishwa	o hlonish w a
ngokuphelele	ng o ku phel el e
ngasemnyango	nga se m nyango
efuna	e fun a
yayifundiswe	y a yi fundis w e
acasuke	a casuk e
yizandla	y i z andla
kunkosazana	ku n kos az ana
yokuhlola	y o ku hlol a
onguyise	o ng u yise
angayilaleli	a nga yi lalel i
ukuhlela	u ku hlel a
isikhulu	i si khulu
ukukholelwa	u ku kholel w a
okusho	o ku sho
kusahlehlela	ku sa hlehl el a
uzokunqoba	u zo ku nqob a
satakishwa	s a takish w a
ungaxoshelwa	u nga xosh el w a
bayoyithola	ba yo yi thol a
kunodaba	kun o daba
ngangikwenza	ng a ngi kw enz a
singadelile	si nga del ile
zehla	z ehl a
ukusangana	u ku sang an a
zehle	z ehl e
asisazi	a si s azi
ngumoya	ng u moya
abahlobo	a ba hlobo
kungapheli	ku nga phel i
esigqikini	e si gqik ini
kwegwebu	kw e gwebu
usezimisele	u se zi m is el e
inkosikazi	i n kosi kazi
eziluhlaza	e zi luhlaza
ayikho	a yi kho
okusemqoka	o ku se m qoka
acabange	a cabang e
ukubuyela	u ku buy el a
ezikhwameni	e zi khwam eni
nami	na mi
daba	daba
okwabizwa	o kw a biz w a
nguye	ngu ye
ushintshi	u shintshi
bokufa	b o ku f a
eyayenziwa	e y a y enz iw a
kwalomuthi	kwa lo mu thi
ukhwembe	u khwembe
sinoyihlo	si n o yihlo
kophahla	k o phahla
eshisiwe	e shis iw e
uyaye	u ya y e
ukuyingena	u ku yi ngen a
lugojwana	lu gojw ana
engathandi	e nga thand i
ezingabalelwa	e zi ngabalel w a
bube	bu b e
ukufa	u ku f a
namagama	n a ma gama
etshelwa	e tshel w a
ngakhangwa	ng a khang w a
iphinifo	i phinifo
kuyiwe	ku yi we
uyafundekela	u ya fundekel a
achithe	a chith e
kazethu	ka z ethu
zicosha	zi cosh a
wesula	w esul a
wangibangisani	w a ngi bang is a ni
kunempilo	ku n e m pil o
siyolisebenza	si yo li sebenz a
esontayo	e sont a yo
esephuma	e se phum a
lakho	la kho
ebe	e b e
sasethembisa	s a s ethemb is a
ukuxoshwa	u ku xosh w a
lakhe	la khe
ubaleke	u balek e
ukulisebenzisa	u ku li sebenz is a
lizophekwa	li zo phek w a
wawungeke	w a wu ngeke
kwasikhathaza	kw a si khathaz a
isigubhukazi	i si gubhu kazi
uyikhombisa	u yi khomb is a
babengcolisile	b a be ngcol is ile
azithumela	a zi thum el a
iyabhuquza	i ya bhuquz a
usuke	u suk e
usuka	u suk a
wazimisa	w a zi m is a
basayina	ba sayin a
usuku	u suku
abazenzayo	a ba z enz a yo
ngowasemagabheni	ng o wa se ma gabh eni
kungifikele	ku ngi fik el e
wayesekade	w a ye se kade
ichithwa	i chith w a
yangilahlekela	y a ngi lahl ek el a
umhlashana	u m hlash ana
r	r
eminyangweni	e mi nyangw eni
ana	ana
ngokulandelana	ng o ku landel an a
sodwa	so dwa
basibona	ba si bon a
ayeyinikwe	a ye yi nik w e
umfazi	u m fazi
besebancane	be se ba ncane
kuhlala	ku hlal a
okumdlukumeze	o ku m dlukumez e
nemijovo	n e mi jov o
nakancane	na ka ncane
kuso	ku so
enkulumeni	e n kulum eni
kusa	ku s a
eningi	e ningi
esebhuqekile	e se bhuq ek ile
sinomahazula	si n o mahazula
esifubeni	e si fub eni
uyisidalwa	u y i si dal w a
ngingayithathaphi	ngi nga yi thath a phi
engaqondi	e nga qond i
sebethandana	se be thand an a
wathola	w a thol a
bengivumelani	be ngi vum el a ni
wabhala	w a bhal a
kungase	ku nga se
uya	u y a
uye	u y e
lesizwe	l e si zwe
xhifi	xhifi
ukukhuluma	u ku khulum a
angeke	a ngeke
ngibashiye	ngi ba shiy e
bavalelise	ba val el is e
bavalelisa	ba valel is a
ongangilingi	o nga ngi ling i
samxaka	s a m xak a
isimilo	i si mil o
ngivuke	ngi vuk e
ayingangaye	a yi nganga ye
gula	gul a
amaningi	a ma ningi
izikhumba	i zi khumba
sila	sil a
waphoqeleka	w a phoqel ek a
angimnike	a ngi m nik e
umnyango	u m nyango
amangwevu	a ma ngwevu
nomamba	n o mamba
ukushalazele	u ku shalaz el e
gqamu	gqamu
usabuyisa	u sa buy is a
eseqalile	e se qal ile
ungemcashele	u nge m cash el e
bavelelwe	ba velel w e
ngicashe	ngi cash e
owayesethanda	o w a ye se thand a
izithukuthuku	i zi thukuthuku
isencane	i se ncane
wokuzibukela	w o ku zi buk el a
uthi	u thi
insizwa	i n sizwa
bededelana	be dedel an a
ngiyaphendula	ngi ya phendul a
ngicwaninga	ngi cwaning a
isimame	i si mame
abelungu	a be lungu
wayekhala	w a ye khal a
siqale	si qal e
acingwe	a cing w e
samafindofindo	s a ma findo findo
namali	na mali
uqoveqove	u qoveqove
nakuye	na ku ye
naphakathi	na phakathi
ngagula	ng a gul a
engani	e nga ni
afinyelele	a finyelel e
ababhuza	a b a bhuz a, a ba bhuz a
waye	w a y e
wasondela	w a sondel a
ezitolo	e zi tolo
akusasho	a ku sa sho
wayengasakuzwa	w a ye nga sa ku zw a
makakhokhelwe	ma ka khokhel w e
kwemibhede	kw e mi bhede
ngizwisise	ngi zw isis e
isuziwa	i suz iw a
ezihlahleni	e zi hlahl eni
ukungcofa	u ku ngcof a
akungihluphi	a ku ngi hluph i
namahlamvu	n a ma hlamvu
bakhuleka	ba khul ek a
yamatshe	y a ma tshe
iyammela	i ya m m el a
imvelo	i m vel o
njengawe	njenga we
noshoti	n o shoti
aphuphe	a phuph e
uyabonakala	u ya bon akal a
enjengaleyo	e njenga le y o
yakhe	ya khe
sithethe	si theth e
belungu	be lungu
awunaye	a wu na ye
emotweni	e motw eni
sophumelela	s o phumelel a
emgungundlovu	e m gungu n dlovu
ezoqala	e zo qal a
bezimkhonze	be zi m khonz e
dolly	dolly
niyabona	ni ya bon a
asamhlupha	a sa m hluph a
kuphela	ku phel a
wayowakholwa	w a yo wa khol w a
kuphele	ku phel e
ungqiphothwe	u ngqiphothwe
uzongizwa	u zo ngi zw a
emqondweni	e m qondw eni
izwi	i zw i
ngenkani	ng e n kani
intokazi	i n to kazi
ngafuna	ng a fun a
kwayo	kwa yo, kw a yo
sebengakuphi	se be nga ku phi
izwe	i zwe
uziphethe	u zi pheth e
useyozifunela	u se yo zi fun el a
isoka	i soka
elivuliwe	e li vul iw e
abakhulu	a ba khulu
epunoni	e punoni
bebaningi	be ba ningi
semali	s e mali
sewejwayela	se w ejwayel a
ukuya	u ku y a
ngathola	ng a thol a
kungani	ku ngani
ababili	a ba bili
sezihambile	se zi hamb ile
ayezibhalelwe	a ye zi bhal el w e
ngezandla	ng e z andla
konke	ko nke
ngingasindi	ngi nga sind i
unkomo	u n komo
oshayelayo	o shay el a yo
wazitshela	w a zi tshel a
engalingana	e nga ling an a
wayezobuye	w a ye zo buye
obabuzayo	o ba buz a yo
uqinela	u qin el a
nesi	nesi
ngiyazi	ngi y azi
iyodwa	i yo dwa
ngokweyisa	ng o kw eyis a
ngokwasemakhaya	ng o kwa se ma khaya
ntambama	ntambama
okubuhlungu	o ku buhlungu
akunakwenzeka	a ku na kw enz ek a
engakabona	e nga ka bon a
abeke	a bek e
sengisecaleni	se ngi se cal eni
udaka	u daka
izohlatshwa	i zo hlatsh w a
mahlangu	ma hlangu
zamehlo	z a me hlo
uyofihlelwa	u yo fihl el w a
adoni	adoni
ababewusebenzisa	a ba be wu sebenz is a
ne	n e
ngiyibhale	ngi yi bhal e
engasho	e nga sho
iyasetshenzelwa	i ya setshenz el w a
ongakuhlolanga	o nga ku hlol anga
akusibo	a ku si bo
sebegeza	se be gez a
uzongishiya	u zo ngi shiy a
yobuhle	y o bu hle
izibambe	i zi bamb e
ngisasho	ngi sa sho
baphuze	ba phuz e
sekuvunywa	se ku vuny w a
angizokubiza	a ngi zo ku biz a
uyinto	u y i n to
beya	be y a
ufuna	u fun a
amanga	a ma nga
wazibamba	w a zi bamb a
ixoxwa	i xox w a
akasafuni	a ka sa fun i
okhipha	o khiph a
lixhoshwa	li xhosh w a
zayo	za yo
zaya	z a y a
amathini	a ma thini
kuwena	ku we na
yehlela	y ehlel a
ejabulisayo	e jabul is a yo
kasikwazi	ka si kw azi
iyinkosi	i y i n kosi
uqwabe	u qwabe
uyagula	u ya gul a
ngezingane	ng e zin gane
owakhe	o wa khe
wathuthumba	w a thuthumb a
wawathatha	w a wa thath a
badinga	ba ding a, b a ding a
ithokozile	i thokoz ile
akawufuni	a ka wu fun i
ubhekisisa	u bhek isis a
ngento	ng e n to
ungihlolelani	u ngi hlol el a ni
untshangase	u ntshangase
ojulukayo	o juluk a yo
babemshaya	b a be m shay a
ingasisiza	i nga si siz a
sifunde	si fund e
esiya	e si y a
bangahlala	ba nga hlal a
ukubonelela	u ku bonel el a
acashise	a cash is e
umenzele	u m enz el e
kungebe	ku ng eb e
ziye	zi y e
isiphuku	i si phuku
ibhodlela	i bhodlela
igxolo	i gxolo
namadodakazi	n a ma doda kazi
ngisuke	ngi suk e
asafisa	a sa fis a
ngumdali	ng u m dal i
ukuzifikisela	u ku zi fik is el a
aze	a ze
nyoni	nyoni
ukuwavimba	u ku wa vimb a
esilungwini	e si lungw ini
anikezwe	a nikez w e
akunyama	a ku nyama
ufika	u fik a
ngalilahla	ng a li lahl a
ufike	u fik e
amadoda	a ma doda
utholakele	u thol akel e
amaprojekti	a ma projekti
ngiyayesaba	ngi ya y esab a
okunye	o ku nye
ethandile	e thand ile
ngezingiqi	ng e zin giqi
eningizimu	e ningi zimu
ukukhombisa	u ku khomb is a
bobesethelelekile	b o be se thel el ek ile
sekunesinyokotho	se ku n e si nyokotho
utangwembe	u tangwembe
isivuvu	i si vuvu
kangixolise	ka ngi xol is e
wawabeka	w a wa bek a
nomakoti	n o makoti
ukuphekela	u ku phek el a
ukugcaba	u ku gcab a
ayibhekayo	a yi bhek a yo
zizokuba	zi zo ku b a
toilet	toilet
sobala	s o bala
wahambisa	w a hamb is a
beshayana	be shay an a
kumagumbi	ku ma gumbi
emthini	e m th ini
nanguya	nan gu ya
lethu	l ethu
eshinga	e shing a
sekwenzekile	se kw enz ek ile
wazama	w a zam a
elikabani	e li ka bani
wesonto	w e sonto
silale	si lal e
ngokunqakisana	ng o ku nqak is an a
uzozithela	u zo zi thel a
asebenzise	a sebenz is e
owazi	o w azi
kwangizuma	kw a ngi zum a
balala	ba lal a
balale	ba lal e
yinganekwane	y i n ganekwane
yinsika	y i n sika
engqondo	e n gqond o
emfuleni	e m ful eni
seliyozilahla	se li yo zi lahl a
amtshele	a m tshel e
akahlakaniphile	a ka hlakaniph ile
zivaleleke	zi val el ek e
namhla	na m hla
izinyama	i zi nyama
nisosizini	ni so siz ini
ngokuthi	ng okuthi
nomfowabo	n o m fo wa bo
ngalelilanga	nga le li langa
yimvume	y i m vum e
kuma	ku m a
uyayidinga	u ya yi ding a
ngilungisa	ngi lung is a
sona	so na
yayithi	y a yi thi
isikhwama	i si khwama
babekhona	b a be kho na
enikina	e nikin a
nisesikoleni	ni se sikol eni
eledlule	e l edlul e
agwilize	a gwiliz e
kuntshangase	ku ntshangase
ezolala	e zo lal a
bamnquma	b a m nqum a, ba m nqum a
ningamaqhawe	ni ng a ma qhawe
kwangiphatha	kw a ngi phath a
udlamini	u dlamini
ayibheke	a yi bhek e
imimango	i mi mango
uyochaza	u yo chaz a
lingenisa	li ngen is a
intombazane	i n tomb az ane
yalesisizwe	ya le si si zwe
sasedukile	s a s eduk ile
ehlombe	e hlombe
uyokwazi	u yo kw azi
makapheke	ma ka phek e
kwashintsha	kw a shintsh a
ingase	i n gase
woma	w om a
engadli	e nga dl i
angithi	a ngi thi
okubi	o ku bi
bagomothelana	ba gomothel an a
kubona	ku bon a
lomsebenzi	lo m sebenz i
isililo	i si lil o
esedlula	e se dlul a
eyayihamba	e ya yi hamb a
ngiyabona	ngi ya bon a
kwayiso	kwa yiso
oqosheme	o qoshem e
ayichonce	a yi chonc e
ukwenzela	u kw enz el a
yazeka	y az ek a
ngiyambongela	ngi ya m bong el a
ubangwa	u bang w a
zomzobe	z o m zobe
sekushomene	se ku shom en e
ongangibhalela	o nga ngi bhal el a
ubingelela	u bingelel a
ithuba	i thuba
eziphethe	e zi pheth e
bezibonela	be zi bon el a
usavuma	u sa vum a
umsebenzi	u m sebenz i
sengimdala	se ngi m dala
babengena	b a be ngen a
babhekane	ba bhek an e
babhekana	ba bhek an a
kwabonakala	kw a bon akal a
engilindile	e ngi lind ile
lafinyelela	l a finyel el a
esihamba	e si hamb a
wazula	w a zul a
ngangazazi	ng a nga z az i
kwekhefu	kw e khefu
emanzini	e ma nz ini
kwawakhanyela	kw a wa khany el a
wayesecuphe	w a yese cuph e, w a yesecuph e
kubhabhalele	ku bhabhalel e
kwala	kw al a
kusengathi	ku sengathi
kwakwenzela	kw a kw enz el a
ngikhathele	ngi khathel e
uyakhala	u ya khal a
sezolandwa	se z o land w a
yisicebi	y i si ceb i
angishaye	a ngi shay e
liyavama	li ya vam a
uzolijwayela	u zo li jwayel a
lesikhombisa	l e si khomb is a
usephazamisekile	u se phazam is ek ile
oye	o y e
ngingathi	ngi nga thi
bazigcina	ba zi gcin a
sekuyimizuzu	se ku y i mi zuzu
okupheka	o ku phek a
ubeyobayobeka	u be yobayob ek a
ngumzali	ng u m zal i
esikhulu	e si khulu
nanto	nan t o
abakufisayo	a b a ku fis a yo, a ba ku fis a yo
bazothini	ba zo thi ni
nanti	nan ti
utshani	u tshani
nofasimba	n o fasimba
ukhuluma	u khulum a
bakhalisa	ba khal is a
eselibhungu	e se li bhungu
ephefeni	e phef eni
lemisho	le mi sho
umshado	u m shad o
ezikhathaza	e zi khathaz a
likanayipuroki	lika nayipuroki
ibheke	i bhek e
olunye	o lu nye
esikhundleni	e si khundl eni
ngibahlanganise	ngi ba hlangan is e
woqobo	w o qobo
izintombi	i zin tombi
nesibongo	n e si bong o
sekubuhlungu	se ku buhlungu
esanda	e sanda
lakhala	l a khal a
yilokho	yi lo kh o
ihlazo	i hlaz o
esekwazi	e se kw azi
kumangalise	ku mangal is e
yilokhu	yi lo khu
okwakuthiwa	o kw a ku th iw a
esukoti	e sukoti
lezo	le z o
ukukudonsela	u ku ku dons el a
beqambe	be qamb e
ize	i ze, i z e
lezi	le zi
ngingathini	ngi nga thi ni
weshumi	w e shumi
lolu	lo lu
babuye	ba buye
akahambe	a ka hamb e
babuya	ba buy a
nangentobeko	na ng e n tobek o
nokobejwayeza	n o k o be jwayez a
unelinye	u n e li nye
ungenwe	u ngen w e
unkwanyana	u nkwany ana
ngasikhihla	ng a si khihl a
kuphume	ku phum e
incwadi	i n cwadi
isifundo	i si fund o
kuphuma	ku phum a
abakholwa	a ba khol w a
elibomvu	e li bomvu
imvula	i m vula
ngumyeni	ng u m yeni
esashaya	e s a shay a
kunye	ku nye
yokukhathala	y o ku khathala
wayesebalindele	w a ye se ba lind el e
esawu	e sa w u
ududana	u dud ana
iphakwe	i phak w e
umuntu	u mu ntu
omamncube	o ma m ncube
esisiza	e si siz a
ngafika	ng a fik a
ngafike	ng a fik e
uyahogela	u ya hogel a
ukuziphatha	u ku zi phath a
kwesikhashana	kw e si khash ana
yayikade	y a yi kad e
zizobasiza	zi zo ba siz a
usefunda	u se fund a
sengingedwana	se ngi nge dw ana
ime	i m e
walujikijela	w a lu jikijel a
sikankosikazi	sika n kosi kazi, sika nkosi kazi
waqalaza	w a qalaz a
kwamalume	kwa malume
semoto	s e moto
egula	e gul a
imuphe	i mu ph e
ingxoxo	i n gxox o
okwesikhashana	o kw e si khash ana
kini	ki ni
kugcizelelwa	ku gcizel el w a
ayifiki	a yi fik i
ethola	e thol a
isingisi	i si ngisi
eziphendula	e zi phendul a
kwasendulo	kwa se n dulo
andise	and is e
osekhulile	o se khul ile
seyizosuka	se yi zo suk a
ukwethenjwa	u kw ethenj w a
ebhekisisa	e bhek isis a
baka	baka
kudele	ku del e
yasendlini	ya se n dl ini
nokufundisa	n o ku fund is a
kudela	ku del a
zifuneka	zi fun ek a
ekude	e kude
ntinini	ntinini
ezwakale	e zw akal e
akufunayo	a ku fun a yo
wayokhela	w a y okhel a
egqumeni	e gqum eni
ngiyobuye	ngi yo buy e
somuntu	s o mu ntu
yilencwadi	yi le n cwadi
sidlaphi	si dl a phi
ngangena	ng a ngen a
nokuhlala	n o ku hlal a
ugogo	u gogo
ukuzidelisa	u ku zidel is a
ngodondolo	ng o dondolo
komuntu	k o mu ntu
eyolubeka	e yo lu bek a
kumnyama	ku mnyama
abaqaphi	a ba qaph i
inkani	i n kani
okabuye	o ka buy e
kakusaziwa	ka ku s az iw a
iqiniso	i qinis o
ayifunayo	a yi fun a yo
esikhulile	e si khul ile, e si khulil e
ngangabe	nga ngabe
siyinkukhu	si y i n kukhu
ingonyama	i n go nyama
ngangimuhle	nga ngimuhle
okungathi	o ku nga thi
wayiphatha	w a yi phath a
ngizifuna	ngi zi fun a
ngilokhu	ngi lokhu
ukungabi	u ku nga b i
ngokushesha	ng o ku shesh a
eselokhu	e se lokhu
ungamazi	u nga m azi
nemibuzo	n e mi buz o
ngincengani	ngi nceng a ni
kwalindela	kw a lindel a
selilapha	se li lapha
silayishwa	si layish w a
wayelithanda	w a ye li thand a
engingabazi	e ngi nga ba z i
balimale	ba limal e
esuke	e suk e
ngomshini	ng o m shini
esuka	e suk a
kwabalingiswa	kw a ba ling is w a
ngibeka	ngi bek a
ungizwisa	u ngi zw is a
ukungishisa	u ku ngi sh is a
futhalala	futhalal a
c	c
wawuphihliza	w a wu phihliz a
ogwayi	o gwayi
kungadala	ku nga dal a
izingwe	i zin gwe
azinithele	a zi nith el e
uzosusa	u zo sus a
mhla	mhla
umamba	u m amba
akamthengiseli	a ka m theng is el i
bathule	ba thul e
owayesanake	o w a ye sa nak e
swi	swi
sizihlalele	si zi hlal el e
izokofa	i zo kof a
acele	a cel e
ibemhlophe	i be mhlophe
emcela	e m cel a
engena	e ngen a
ungaphika	u nga phik a
engene	e ngen e
bengawazi	be nga w azi
abashayeli	a ba shayel i
ngesigcwele	ng e si gcwel e
bahlubuka	ba hlubuk a
akoni	a k on i
mhogelise	m hog el is e
inyama	i nyama
likhwembekhwembeze	li khwemb e khwembez e
balesisizwe	ba le si si zwe
ingatholwa	i nga thol w a
uxaba	u xab a, u xaba
empini	e m p ini
wasezinweba	w a se zi nweb a
akamkhombisi	a ka m khomb is i
uxolo	u xolo
kwavele	kw a vel e
wayolala	w a yo lal a
ngomuntu	ng o mu ntu
emisebenzini	e mi sebenz ini
waphelela	w a phel el a
nimbambe	ni m bamb e
izikhali	i zi khali
yombuso	y o m bus o
ngikwenzile	ngi kw enz ile
ihlezi	i hlez i
imoto	i moto
okwakungeze	o kw a ku ng ez e
wadukluza	w a dukluz a
uyoxoshwa	u yo xosh w a
abrahama	abrahama
ngokucasha	ngo ku cash a
yayosithela	y a yo si th el a
wazwiba	w a zwib a
angikwesabi	a ngi kw esab i
bazinza	ba zinz a
esexola	e se xol a
indebe	i n debe
nemamba	n e mamba
sihambe	si hamb e
aphele	a phel e
ungawazi	u nga w azi
wayebuye	w a ye buy e
ngingaxabana	ngi nga xab an a
zingakuboni	zi nga ku bon i
ukuqashelwa	u ku qash el w a
ngiphinde	ngi phind e
nathi	na thi
izenzela	i z enz el a
abazifisayo	a ba zi fis a yo
kwakungukwahlukaniselwa	kw a ku ngu kwa hlukan is el w a
umsindo	u m sind o
ayizikholwa	a yi zi kholw a
izitembu	i zi tembu
nkindlane	n kindl ane
kuphiliwe	ku phil iw e
enhle	e n hle
eseyibukisisa	e se yi buk isis a
ehhovisi	e hhovisi
abafundi	a ba fund i
indishi	i n dishi
sitimela	si timela
inkinsela	i n kinsela
abafunde	a ba fund e
owayemtshela	o w a ye m tshel a
nezingubo	n e zin gubo
lingena	li ngen a
liyeza	li y ez a
ngizoshona	ngi zo shon a
ngokulokhu	ng o ku lokhu
wesithembu	w e si thembu
ukucabanga	u ku cabang a
akanandaba	aka na ndaba
ngizokucela	ngi zo ku cel a
owawungeyibone	o w a wu nge yi bon e
izicathulo	i zi cathul o
imisebenzi	i mi sebenz i
uyongixolela	u yo ngi xol el a
sengifike	se ngi fik e
sagcina	s a gcin a
kunzima	ku nzima
esembhince	e se m bhinc e
emangalisayo	e mangal is a yo
engibhuqa	e ngi bhuq a
ozovalelisa	o zo val el is a
behlakazeka	be hlakaz ek a
kushiwo	ku sh iw o
ngiqale	ngi qal e
yakhuza	y a khuz a
amaphuzu	a ma phuzu
kancane	ka ncane
ngikuchazele	ngi ku chaz el e
besingadala	be si nga dal a
lingakubani	li nga ku bani
utshwala	u tshwala
asebenzela	a sebenz el a
sokukuthungela	s o ku ku thung el a
beyakubamba	be ya ku bamb a
useyesabeka	u se y esab ek a
kulona	ku lo na
abangene	a ba ngen e
omfushane	o m fush ane
yokuphekela	y o ku phek el a
uyisuse	u yi sus e
okwamxaka	o kw a m xak a
ukuxolisa	u ku xol is a
ugwayi	u gwayi
nisize	ni siz e
okukhulu	o ku khulu
ngididwa	ngi did w a
wayincela	w a yi ncel a
ngizigxiviza	ngi zi gxiviz a
komphefumulo	k o m phefumul o
iyingelosi	i y i n gelosi
lona	lo na
ibuze	i buz e
selafa	se l a f a
ukunyakaza	u ku nyakaz a
umhlane	u mhlane
nesibindi	n e si bindi
waqhiphela	w a qhiph el a
eramsesi	e ramsesi
esephumile	e se phum ile
wayephakamisa	w a ye phakam is a
emathilamini	e ma thilam ini
ayengawafanele	a ye nga wa fan el e
eposini	e pos ini
umkankwanyana	u m kankwany ana
ovutha	o vuth a
kungaze	ku nga ze
kungafuneki	ku nga fun ek i
kwezimpahla	kw e zim pahla
sekusile	se ku s ile
ngesokusa	ng e s o ku s a
ukuyobamba	u ku yo bamb a
asizange	a si zange
nokho	nokho
bayehla	ba y ehl a
sekungumkhusu	se ku ng u m khusu
ukumbuka	u ku mbuk a
bakhokhelwa	ba khokh el w a
nobhokide	n o bhokide
izindwani	i zin dwani
ngesonto	ng e sonto
nezinqulu	n e zin qulu
afanele	a fanel e
nokaba	n o ka b a
lashona	l a shon a
nakuphefumula	n a ku phefumul a
ngiyafunga	ngi ya fung a
dukuduku	dukuduku
kufane	ku fan e
bephuma	be phum a
kufana	ku fan a
zithole	zi thol e
emabhange	e ma bhange
wahalalisa	w a halal is a
useyashweleza	u se ya shwelez a
nasi	na si
naso	na so
indlamu	i n dlamu
kakhulu	kakhulu, ka khulu
nihlanganise	ni hlangan is e
wenkosi	w e n kosi
zingalikhuthalela	zi nga li khuthal el a
angiyifiseli	a ngi yi fis el i
ngalejwayela	ng a l ejwayel a
enonophele	e nonophel e
wambona	w a m bon a
ummeli	u m m el i
sangaxoxa	s a nga xox a
ukuziphoxa	u ku ziphox a
liyazithandela	li ya zi thand el a
ngingakhwelanga	ngi nga khwel anga
imvunulo	i m vunul o
isaphumile	i sa phum ile
ezindlini	e zi ndl ini
walibhekisaphi	w a li bhek is a phi
bamkhonza	b a m khonz a
ayishumi	a y i shumi
yendlala	y e n dlala
ababemazi	a ba be m azi
wababaza	w a babaz a
siyotholana	si yo thol an a
uqinisile	u qin is ile
kawasoze	ka wa so ze
selimnyama	se li mnyama
ngiwulole	ngi wu lol e
eseciba	e se cib a
bazithela	ba zi th el a
iyazikhulumela	i ya zi khulum el a
namanzi	n a ma nzi
bengazi	be ng azi
ekuseni	e ku s eni
bakulowaya	b a ku lo wa ya
ngimbona	ngi m bon a
ukubuya	u ku buy a
ngizokutshela	ngi zo ku tshel a
wayehlala	w a yehlal a
eminingi	e mi ningi
onesi	o nesi
kuthushuka	ku thushuk a
yiso	yi so
kubhalwe	ku bhal w e
izindlebe	i zin dlebe
nezibi	n e zi bi
nentebe	n entebe
bakwethu	ba kw ethu
wawathathaphi	w a wa thath a phi
ngiphuthwe	ngi phuth w e
emayo	e m a yo
bengena	be ngen a
kungenzeki	ku ng enz ek i
angaphela	a nga phel a
ngalapho	nga laph o
kungenzeka	ku ng enz ek a
ubika	u bik a
makhala	makhala
ngane	n gane
esengasekho	e se nga se kho
lwehlele	lw ehlel e
isisusa	i si susa
babezikhalela	b a be zi khal el a
wayengumuntu	w a ye ng u mu ntu
yokusina	y o ku sin a
unatana	u natana
khilithi	khilithi
uzilalele	u zi lalel e
akudliwa	a ku dl iw a
ayabuzisana	a y a buzis an a
zishayise	zi shay is e
ngiyasola	ngi ya sol a
ezimnyama	e zi mnyama
eshaye	e shay e
eshaya	e shay a
kwedlulela	kw edlul el a
omanase	o manase
iyofela	i yo fel a
kuduma	ku dum a
zafunda	z a fund a
wayemthembisile	w a ye m themb is ile
uphindele	u phind el e
zazimhambele	z a zi m hamb el e
iyobasiza	i yo ba siz a
kucabanga	ku cabang a
siphenduke	si phenduk e
inhliziyo	i n hliziyo
washeshe	w a shesh e
washesha	w a shesh a
ukuxhasa	u ku xhas a
unkezo	u n kezo
kufanele	ku fanel e
sibheke	si bhek e
ukudlana	u ku dl an a
sokuquleka	s o ku qul ek a
esebomvu	e se bomvu
balikuqakuqa	b a li kuqakuq a
emgidini	e m gid ini
sokuvuleka	s o ku vul ek a
zitotoba	zi totob a
ukuyofunda	u ku yo fund a
ukuzenza	u ku zenz a
ngalolu	nga lo lu
ngobudala	ng o bu dala
sasihamba	s a si hamb a
akanayo	a ka na yo
bakanozimanga	baka no zi manga
zaphuma	z a phum a
akanaye	a ka na ye
sikhathi	si khathi
ngiyiqeda	ngi yi qed a
akupuneki	a ku pun ek i
eseyiqedile	e se yi qed ile
bacabanga	ba cabang a
abuse	a bus e
uzidonsela	u zi dons el a
ngikhona	ngi kho na
lomgwaqo	l o m gwaqo
wawuthatha	w a wu thath a
nokuthi	n o kuthi
injani	i njani
sichezuke	si chezuk e
akuyena	a ku ye na
emphuthuma	e m phuthum a
kulombuzo	ku lo m buz o
kwabangeka	kw a bang ek a
umphefumulo	u m phefumul o
kwakhanya	kw a khany a
makwenziwenjani	ma kw enz iw e njani
yokukulungisa	y o ku ku lung is a
wawo	wa wo
umbuze	u m buz e
ayisimangaliso	a y i si mangal is o
kuthandazwa	ku thandaz w a
umbuzo	u m buz o
kuthandazwe	ku thandaz w e
impambakwici	i m pambakwici
umbhele	u m bhele
usebhekabhekile	u se bhek a bhek ile
umlangeni	u m lang eni
useyibeke	u se yi bek e
iqamba	i qamb a
amakhekhe	a ma khekhe
ingasese	i nga se se
ethenga	e theng a
ngivume	ngi vum e
asebesebenza	a sebe sebenz a
nommbila	n o m mbila
isitha	i si tha
unkulavele	u nkulavele
ungiphathe	u ngi phath e
uyazimonyonga	u ya zi monyong a
kuqhamuka	ku qhamuk a
sesishilo	se si sh ilo
lonke	lo nke
ugendeni	u gend e ni
kokunye	k o ku nye
negazi	n e gazi
uyalinganisa	u ya lingan is a
usasho	u sa sho
umbingelela	u m bingelel a
bayithini	ba yi thi ni
indlela	i n dlela
eshadayo	e shad a yo
unomusa	u n o mu sa
ephakeme	e phakem e
kangako	ka ngako
kangaki	ka ngaki
kokungqongqoza	k o ku ngqongqoz a
kangaka	ka ngaka
iyamunyungwa	i ya munyung w a
ziphela	zi phel a
babukana	b a buk an a
kuyachichima	ku ya chichim a
ayeyilo	a ye yi lo
lendaba	l e n daba
babezozwa	ba be zo zw a
kusuke	ku suk e
ubhale	u bhal e
besingobani	be si ng o bani
lelibhubesi	le li bhubesi
sezivevezela	se zi vevez el a
uqhamukephi	u qhamuk e phi
esaziduduza	e sa zi duduz a
yayaphi	y a y a phi
sengizozwa	se ngi zo zw a
ungabe	u ngabe
ebuzwa	e buz w a
onkosazana	o n kos az ana
namaningi	na ma ningi
eyakithi	e ya ki thi
sekuvela	se ku vel a
kungafundwa	ku nga fund w a
eyilithemba	e yi li themb a
usephumule	u se phumul e
angiphuze	a ngi phuz e
oholibama	o holibama
ngabona	ng a bon a
wahlala	w a hlal a
lwakhona	lwa kho na
isibindi	i si bindi
iphutha	i phutha
usombenyase	u so mbeny a se
ekuntshontsheni	e ku ntshontsh eni
adideke	a did ek e
iwesishiyagalombili	i w e si shiy a galo m bili
ngiyakwexwaya	ngi ya kw exway a
nokuwamelela	n o ku w amel el a
ngomuso	ng o mu so
nalowo	na lo w o
azivokele	a zi vok el e
siyojika	si yo jik a
ashayise	a shay is e, a shayis e
ngezimoto	ng e zi moto
zawo	za wo
wabuya	w a buy a
sengibona	se ngi bon a
wabuye	w a buy e, w a buye
indodana	i n dod ana
engangikhuluma	e ng a ngi khulum a
ekhe	e kh e
ukuhlanganisa	u ku hlangan is a
nenhlanhla	n e n hlanhla
isidumbu	i si dumbu
isisuthu	i si suthu
waxakoka	w a xakok a
siyakwenza	si ya kw enz a
azihlalele	a zi hlal el e
ngamakhaza	nga ma khaza
ngangizohamba	ng a ngi zo hamb a
yilowonkosikazi	yi lo w o n kosi kazi, yi lo w o nkosi kazi
nithuke	ni thuk e
kwakunezincwadi	kw a ku n e zin cwadi
sokholo	s o khol o
awodwa	a wo dwa
amaqhawe	a ma qhawe
ngayiqala	ng a yi qal a
esabuza	e sa buz a
ngizithulele	ngi zi thul el e
uwafundisela	u wa fund is el a
etsheni	e tsh eni
ayikhulumi	a yi khulum i
ungene	u ngen e
wayengazihluphelani	w a ye nga zi hluph el a ni
usekhohliwe	u se khohl iw e
lokuziveza	l o ku zi vez a
kudala	ku dala
ngingaze	ngi nga ze
ngalalela	ng a lalel a
amahleza	a ma hleza
malunga	ma lunga
ngingazi	ngi ng azi
usofa	u sofa
simemeza	si memez a
ongibizele	o ngi biz el e
efanayo	e fan a yo
yokubuya	y o ku buy a
ngikuhluphe	ngi ku hluph e
kuhlekwe	ku hlek w e
wazisonga	w a zi song a
kulaba	ku la ba
uyaludinga	u ya lu ding a
kulabo	ku la b o
ukudubula	u ku dubul a
elase	e l a se
lishayile	li shay ile
wazibhonxula	w a zi bhonxul a
kunogwaja	ku no gwaja
zendelelo	z e n delel o
okwakukade	o kw a ku kade
izithombe	i zi thombe
kungahwalala	ku nga hwalal a
enganakuphendulwa	e nga na ku phendul w a
kuthisha	ku thisha
esiqondene	e si qond en e
ngiyathandaza	ngi ya thandaz a
nimkhweze	ni m khwez e
ngeswela	ng eswel a
amakhulu	a ma khulu
mahlayeni	ma hlayeni
usengcono	u se ngcono
luyaphahleka	lu ya phahl ek a
simfundile	si m fund ile
engiyizwayo	e ngi yi zw a yo
abafundisi	a ba fund is i
izimpendulo	i zim pendul o
ozojuqa	o zo juq a
namaphepha	n a ma phepha
wagxuma	w a gxum a
lalizokuba	l a li zo ku b a
walo	wa lo
ngifuna	ngi fun a
ngikuthole	ngi ku thol e
wathathela	w a thathel a
ngangingakwazi	ng a ngi nga kw azi
kuyabahlwa	ku ya ba hlw a
linjani	li njani
ixhegu	i xhegu
esimweni	e si mw eni
kusasiza	ku sa siz a
ebila	e bil a
imicibisholo	i mi cibisholo
selikude	se li ku de
phela	phela
sekufuneka	se ku fun ek a
ngosizwile	ng o si zw ile
uyisiphukuphuku	u y i si phuku phuku
silindile	si lind ile
ngimuzwa	ngi mu zw a
endala	e n dala
zazizame	z a zi zam e
kusale	ku sal e
ukuthi	u ku thi
ngitshele	ngi tshel e
lezizindawo	le zi zin dawo
nezinkabi	n e zin kabi
ngeyakhe	ng e ya khe
wawumkhulu	w a wu m khulu
uzoxolisa	u zo xol is a
sengikhathele	se ngi khathel e
izokwenzenjani	i zo kw enz e njani
ebulale	e bulal e
zasina	z a sin a
uyabheda	u ya bhed a
kuke	kuke
babuyisa	ba buy is a
amabhodlela	a ma bhodlela
okwenkosikazi	o kw e n kosi kazi
yabuyela	y a buy el a
owayengayinakile	o w a ye nga yi nak ile
wamangala	w a mangal a
yikho	yi kho
okunukayo	o ku nuk a yo
usenza	u s enz a
ezohlala	e zo hlal a
usenze	u s enz e
yitshe	y i tshe
umlungu	u m lungu
njengezihlabathi	njeng e zi hlabathi
beyocambalala	be yo cambalal a
ngamaningi	nga ma ningi
ijezi	i jezi
awufikanga	a wu fik anga
elakhona	e la kho na
nobomvu	n o bomvu
amakhosikazi	a ma khosi kazi
udalwa	u dal w a
kuyachachaza	ku ya chachaz a
kodwa	kodwa
ukungibona	u ku ngi bon a
bayibona	ba yi bon a
nguyena	ngu ye na
bayibone	ba yi bon e
sengehlulekile	se ng ehlul ek ile
zibhodongo	zi bhodongo
ayigugu	a y i gugu
yisihlalo	y i si hlal o
bekuvumelani	be ku vum el a ni
ukudlala	u ku dlal a
kuthule	ku thul e
kuthula	ku thul a
sekuzwakele	se ku zw akel e
eliyinkuluvele	e li y i n kulu vele
sebekhuluma	se be khulum a
lwalo	lwa lo
sisazozama	si sa zo zam a
njani	njani
ashiye	a shiy e
esakufuna	e sa ku fun a
engalweni	e n galw eni
babethi	ba be thi
sifika	si fik a
angilethela	a ngi lethel a
igwababa	i gwababa
esegulela	e se gul el a
usuthi	u suthi
kuleya	ku le ya
kuleyo	ku le y o
esihleli	e si hlel i
kunabanye	kun a ba nye
nasezingqondweni	na se zin gqond w eni
ashaye	a shay e
zomhlaba	z o m hlaba
bezovalelwa	be zo val el w a
kungasekho	ku nga se kho
ngeke	ngeke
ngokuphikisana	ng o ku phik is an a
umashu	u mashu
endle	e n dle
kuyinsini	ku y i n sini
akhe	a kh e, a khe
kumbe	ku mb e
belu	belu
uthuli	u thuli
emsebenzini	e m sebenz ini
abaqondene	a ba qond en e
eziguli	e zi gul i
yaba	y a b a
yabe	y a b e
kufunyaniseke	ku funy an is ek e
ayitholile	a yi thol ile
esihosheni	e si hosh eni
isimongo	i si mongo
yendawo	y e n dawo
yabo	ya bo
kunezinkungu	ku n e zin kungu
asho	a sho
usulapha	u s u lapha
budebuduze	budebuduze
sekukude	se ku ku de
umgobhozi	u m gobhoz i
ngomnyango	ng o m nyango
ilele	i lel e
ongagculisi	o nga gcul is i
sekusondele	se ku sondel e
ngiyinkatha	ngi y i n katha
angilindele	a ngi lind el e
asizethwele	a si z ethwel e
elibangisa	e li bang is a
kokuphumula	k o ku phumul a
nomunye	n o mu nye
kungukudla	ku ng u ku dl a
sesavala	se s a val a
isizungu	i si zungu
yemisebenzi	y e mi sebenzi
wayehlupheka	w a ye hluph ek a
izimoto	i zi moto
nabagulayo	n a ba gul a yo
zisuke	zi suk e
walamula	w a lamul a
ngesihle	ng e si hle
imithwalo	i mi thwal o
leziyazikhathi	le zi ya zi khathi
bathandana	ba thand an a, b a thand an a
ilandelana	i landel an a
baqaphele	ba qaphel e
ubebuzela	u be buz el a
zingakumeli	zi nga ku m el i
usambeke	u sa m bek e
esafunda	e sa fund a
wesihhomuhhomu	w e si hhomu hhomu, w e si hhomuhhomu
oyenzile	o y enz ile
umtshele	u m tshel e
umtshela	u m tshel a
ngamaphutha	ng a ma phutha
zimxinile	zi m xin ile
esiminyaminyeni	e si minyaminy eni
zigcwele	zi gcwel e
abazothenga	a ba zo theng a
sengiyobona	se ngi yo bon a
juluka	juluk a
ekwazi	e kw azi
useyokuzwa	u se yo ku zw a
bebancane	be ba ncane
ususikhipha	u s u si khiph a
inesithunzi	i n e si thunzi
likayisemkhulu	lika yise m khulu
ehlekisa	e hlek is a
ngiyethembisa	ngi y ethemb is a
lagege	l a geg e
amafutha	a ma futha
wayenganqaba	w a ye nga nqab a
ngikhosele	ngi khosel e
abayidlayo	a ba yi dl a yo
iyelapha	i y e lapha
angafike	a nga fik e
nkosi	n kosi
angafiki	a nga fik i
okuncane	o ku ncane
ndodakazi	n doda kazi
sase	sa se
indaba	i n daba
abamlindile	a ba m lind ile
akusho	a ku sho
buthongo	bu thongo
nhla	nhla
elovu	e lovu, elovu
ikakhulukazi	i ka khulu kazi
